id	chrom	start_pos	end_pos	size	gc_content
1	Sc_chr04	0	434	434	0.5253456221198156
2	Sc_chr04	434	1197	763	0.3709043250327654
3	Sc_chr04	1197	1232	35	0.45714285714285713
4	Sc_chr04	1232	1888	656	0.40396341463414637
5	Sc_chr04	1888	2152	264	0.38636363636363635
6	Sc_chr04	2152	3665	1513	0.3648380700594845
7	Sc_chr04	3665	3977	312	0.3782051282051282
8	Sc_chr04	3977	5000	1023	0.343108504398827
9	Sc_chr04	5000	5222	222	0.33333333333333337
10	Sc_chr04	5222	5529	307	0.3778501628664495
11	Sc_chr04	5529	5590	61	0.42622950819672134
12	Sc_chr04	5590	6092	502	0.38645418326693226
13	Sc_chr04	6092	6494	402	0.4502487562189054
14	Sc_chr04	6494	6906	412	0.3859223300970874
15	Sc_chr04	6906	7706	800	0.39
16	Sc_chr04	7706	7965	259	0.38610038610038605
17	Sc_chr04	7965	8390	425	0.3247058823529412
18	Sc_chr04	8390	11328	2938	0.39176310415248466
19	Sc_chr04	11328	11654	326	0.35582822085889565
20	Sc_chr04	11654	12280	626	0.4073482428115016
21	Sc_chr04	12280	12394	114	0.39473684210526316
22	Sc_chr04	12394	12513	119	0.4621848739495798
23	Sc_chr04	12513	12535	22	0.45454545454545453
24	Sc_chr04	12535	12847	312	0.44230769230769235
25	Sc_chr04	12847	12889	42	0.38095238095238093
26	Sc_chr04	12889	14091	1202	0.37687188019966716
27	Sc_chr04	14091	14117	26	0.3846153846153846
28	Sc_chr04	14117	14169	52	0.3846153846153846
29	Sc_chr04	14169	14325	156	0.3653846153846154
30	Sc_chr04	14325	16217	1892	0.33298097251585623
31	Sc_chr04	16217	16360	143	0.4195804195804196
32	Sc_chr04	16360	16394	34	0.4705882352941177
33	Sc_chr04	16394	16532	138	0.5217391304347826
34	Sc_chr04	16532	16559	27	0.4074074074074074
35	Sc_chr04	16559	16661	102	0.4411764705882353
36	Sc_chr04	16661	16956	295	0.4271186440677966
37	Sc_chr04	16956	17136	180	0.4277777777777778
38	Sc_chr04	17136	17638	502	0.3884462151394423
39	Sc_chr04	17638	17879	241	0.39004149377593367
40	Sc_chr04	17879	18812	933	0.41479099678456594
41	Sc_chr04	18812	19053	241	0.3319502074688797
42	Sc_chr04	19053	19215	162	0.42592592592592593
43	Sc_chr04	19215	19243	28	0.42857142857142855
44	Sc_chr04	19243	19381	138	0.4057971014492754
45	Sc_chr04	19381	19475	94	0.3404255319148936
46	Sc_chr04	19475	20248	773	0.35575679172056923
47	Sc_chr04	20248	22014	1766	0.3607021517553794
48	Sc_chr04	22014	22249	235	0.37446808510638296
49	Sc_chr04	22249	22480	231	0.4069264069264069
50	Sc_chr04	22480	22847	367	0.3651226158038147
51	Sc_chr04	22847	23317	470	0.38085106382978723
52	Sc_chr04	23317	23617	300	0.36333333333333334
53	Sc_chr04	23617	23731	114	0.4298245614035088
54	Sc_chr04	23731	24196	465	0.34623655913978496
55	Sc_chr04	24196	24253	57	0.3157894736842105
56	Sc_chr04	24253	24452	199	0.35678391959798994
57	Sc_chr04	24452	24877	425	0.3905882352941177
58	Sc_chr04	24877	25080	203	0.4236453201970443
59	Sc_chr04	25080	25478	398	0.3668341708542714
60	Sc_chr04	25478	26171	693	0.31457431457431456
61	Sc_chr04	26171	26791	620	0.31451612903225806
62	Sc_chr04	26791	27582	791	0.3097345132743363
63	Sc_chr04	27582	27992	410	0.3170731707317073
64	Sc_chr04	27992	29034	1042	0.3934740882917466
65	Sc_chr04	29034	29139	105	0.42857142857142855
66	Sc_chr04	29139	29200	61	0.47540983606557374
67	Sc_chr04	29200	29322	122	0.47540983606557374
68	Sc_chr04	29322	29790	468	0.4594017094017094
69	Sc_chr04	29790	29961	171	0.4093567251461988
70	Sc_chr04	29961	30258	297	0.4107744107744108
71	Sc_chr04	30258	30279	21	0.33333333333333337
72	Sc_chr04	30279	31105	826	0.364406779661017
73	Sc_chr04	31105	31226	121	0.4628099173553719
74	Sc_chr04	31226	31604	378	0.36772486772486773
75	Sc_chr04	31604	31648	44	0.40909090909090906
76	Sc_chr04	31648	32471	823	0.36938031591737547
77	Sc_chr04	32471	33031	560	0.4142857142857143
78	Sc_chr04	33031	34013	982	0.34419551934826886
79	Sc_chr04	34013	34871	858	0.351981351981352
80	Sc_chr04	34871	35135	264	0.4128787878787879
81	Sc_chr04	35135	35207	72	0.3194444444444444
82	Sc_chr04	35207	35231	24	0.45833333333333337
83	Sc_chr04	35231	35849	618	0.38349514563106796
84	Sc_chr04	35849	36124	275	0.4
85	Sc_chr04	36124	37823	1699	0.3978811065332548
86	Sc_chr04	37823	38488	665	0.4
87	Sc_chr04	38488	39221	733	0.3560709413369713
88	Sc_chr04	39221	39324	103	0.34951456310679613
89	Sc_chr04	39324	39367	43	0.34883720930232553
90	Sc_chr04	39367	39874	507	0.4161735700197239
91	Sc_chr04	39874	40227	353	0.3937677053824363
92	Sc_chr04	40227	40792	565	0.37168141592920356
93	Sc_chr04	40792	40976	184	0.43478260869565216
94	Sc_chr04	40976	42204	1228	0.4014657980456026
95	Sc_chr04	42204	42222	18	0.5555555555555556
96	Sc_chr04	42222	43029	807	0.38661710037174724
97	Sc_chr04	43029	43494	465	0.46236559139784944
98	Sc_chr04	43494	43586	92	0.42391304347826086
99	Sc_chr04	43586	43595	9	0.4444444444444444
100	Sc_chr04	43595	43644	49	0.42857142857142855
101	Sc_chr04	43644	43825	181	0.3370165745856354
102	Sc_chr04	43825	44036	211	0.2843601895734597
103	Sc_chr04	44036	45047	1011	0.4292779426310584
104	Sc_chr04	45047	46081	1034	0.40135396518375244
105	Sc_chr04	46081	46931	850	0.3835294117647059
106	Sc_chr04	46931	47041	110	0.3818181818181818
107	Sc_chr04	47041	47121	80	0.4375
108	Sc_chr04	47121	47253	132	0.38636363636363635
109	Sc_chr04	47253	47322	69	0.42028985507246375
110	Sc_chr04	47322	47829	507	0.40039447731755423
111	Sc_chr04	47829	48463	634	0.3643533123028391
112	Sc_chr04	48463	48745	282	0.3687943262411348
113	Sc_chr04	48745	48788	43	0.32558139534883723
114	Sc_chr04	48788	48807	19	0.368421052631579
115	Sc_chr04	48807	48820	13	0.3846153846153846
116	Sc_chr04	48820	48877	57	0.4912280701754386
117	Sc_chr04	48877	49008	131	0.3816793893129771
118	Sc_chr04	49008	49222	214	0.45327102803738323
119	Sc_chr04	49222	49592	370	0.35945945945945945
120	Sc_chr04	49592	49762	170	0.3411764705882353
121	Sc_chr04	49762	49896	134	0.3507462686567164
122	Sc_chr04	49896	49973	77	0.33766233766233766
123	Sc_chr04	49973	49988	15	0.26666666666666666
124	Sc_chr04	49988	50066	78	0.34615384615384615
125	Sc_chr04	50066	51449	1383	0.3499638467100506
126	Sc_chr04	51449	51569	120	0.475
127	Sc_chr04	51569	51670	101	0.42574257425742573
128	Sc_chr04	51670	51965	295	0.43389830508474575
129	Sc_chr04	51965	51979	14	0.35714285714285715
130	Sc_chr04	51979	52361	382	0.42146596858638746
131	Sc_chr04	52361	52406	45	0.37777777777777777
132	Sc_chr04	52406	52506	100	0.32
133	Sc_chr04	52506	52584	78	0.4230769230769231
134	Sc_chr04	52584	52720	136	0.33088235294117646
135	Sc_chr04	52720	52792	72	0.4444444444444444
136	Sc_chr04	52792	53744	952	0.38865546218487396
137	Sc_chr04	53744	54184	440	0.33409090909090905
138	Sc_chr04	54184	55585	1401	0.3968593861527481
139	Sc_chr04	55585	55888	303	0.38283828382838286
140	Sc_chr04	55888	56612	724	0.3632596685082873
141	Sc_chr04	56612	57905	1293	0.36272235112142304
142	Sc_chr04	57905	58021	116	0.4051724137931034
143	Sc_chr04	58021	58852	831	0.4019253910950662
144	Sc_chr04	58852	59330	478	0.38912133891213385
145	Sc_chr04	59330	59432	102	0.4705882352941177
146	Sc_chr04	59432	59492	60	0.5
147	Sc_chr04	59492	59597	105	0.39047619047619053
148	Sc_chr04	59597	61955	2358	0.4351145038167939
149	Sc_chr04	61955	62234	279	0.4516129032258065
150	Sc_chr04	62234	62447	213	0.5305164319248826
151	Sc_chr04	62447	62698	251	0.4741035856573705
152	Sc_chr04	62698	63214	516	0.47480620155038755
153	Sc_chr04	63214	63541	327	0.4036697247706422
154	Sc_chr04	63541	63665	124	0.5887096774193548
155	Sc_chr04	63665	63691	26	0.4230769230769231
156	Sc_chr04	63691	63788	97	0.4329896907216495
157	Sc_chr04	63788	64174	386	0.4378238341968912
158	Sc_chr04	64174	64757	583	0.3602058319039451
159	Sc_chr04	64757	64813	56	0.42857142857142855
160	Sc_chr04	64813	64828	15	0.4
161	Sc_chr04	64828	66698	1870	0.3582887700534759
162	Sc_chr04	66698	66731	33	0.3939393939393939
163	Sc_chr04	66731	66929	198	0.4343434343434343
164	Sc_chr04	66929	67272	343	0.4839650145772595
165	Sc_chr04	67272	67347	75	0.52
166	Sc_chr04	67347	67803	456	0.3355263157894737
167	Sc_chr04	67803	68501	698	0.40974212034383956
168	Sc_chr04	68501	68639	138	0.38405797101449274
169	Sc_chr04	68639	68750	111	0.35135135135135137
170	Sc_chr04	68750	69515	765	0.38169934640522873
171	Sc_chr04	69515	69727	212	0.3113207547169811
172	Sc_chr04	69727	69751	24	0.45833333333333337
173	Sc_chr04	69751	70076	325	0.3907692307692308
174	Sc_chr04	70076	70348	272	0.375
175	Sc_chr04	70348	70866	518	0.3397683397683398
176	Sc_chr04	70866	70899	33	0.4242424242424242
177	Sc_chr04	70899	71361	462	0.37878787878787873
178	Sc_chr04	71361	71565	204	0.3578431372549019
179	Sc_chr04	71565	71639	74	0.40540540540540543
180	Sc_chr04	71639	71940	301	0.40199335548172754
181	Sc_chr04	71940	72285	345	0.39710144927536234
182	Sc_chr04	72285	72373	88	0.2840909090909091
183	Sc_chr04	72373	73245	872	0.3451834862385321
184	Sc_chr04	73245	73738	493	0.3488843813387424
185	Sc_chr04	73738	73767	29	0.4482758620689655
186	Sc_chr04	73767	73974	207	0.34782608695652173
187	Sc_chr04	73974	74486	512	0.404296875
188	Sc_chr04	74486	74586	100	0.41
189	Sc_chr04	74586	74780	194	0.4020618556701031
190	Sc_chr04	74780	74921	141	0.3829787234042554
191	Sc_chr04	74921	75138	217	0.42396313364055305
192	Sc_chr04	75138	75458	320	0.34375
193	Sc_chr04	75458	75527	69	0.33333333333333337
194	Sc_chr04	75527	75552	25	0.44
195	Sc_chr04	75552	75568	16	0.375
196	Sc_chr04	75568	75650	82	0.4390243902439025
197	Sc_chr04	75650	76430	780	0.3948717948717949
198	Sc_chr04	76430	77522	1092	0.3937728937728938
199	Sc_chr04	77522	77593	71	0.43661971830985913
200	Sc_chr04	77593	77648	55	0.43636363636363634
201	Sc_chr04	77648	77884	236	0.4152542372881356
202	Sc_chr04	77884	78466	582	0.35738831615120276
203	Sc_chr04	78466	79147	681	0.38179148311306904
204	Sc_chr04	79147	79433	286	0.32167832167832167
205	Sc_chr04	79433	79924	491	0.395112016293279
206	Sc_chr04	79924	80802	878	0.38838268792710706
207	Sc_chr04	80802	81272	470	0.35106382978723405
208	Sc_chr04	81272	81605	333	0.3603603603603604
209	Sc_chr04	81605	82134	529	0.389413988657845
210	Sc_chr04	82134	82701	567	0.36155202821869487
211	Sc_chr04	82701	83268	567	0.36507936507936506
212	Sc_chr04	83268	83724	456	0.381578947368421
213	Sc_chr04	83724	83751	27	0.2962962962962963
214	Sc_chr04	83751	84457	706	0.3994334277620396
215	Sc_chr04	84457	85381	924	0.4036796536796537
216	Sc_chr04	85381	85846	465	0.3956989247311828
217	Sc_chr04	85846	86144	298	0.3322147651006711
218	Sc_chr04	86144	86538	394	0.37055837563451777
219	Sc_chr04	86538	86845	307	0.38762214983713356
220	Sc_chr04	86845	87304	459	0.4335511982570806
221	Sc_chr04	87304	87470	166	0.3072289156626506
222	Sc_chr04	87470	87796	326	0.4325153374233129
223	Sc_chr04	87796	88433	637	0.3626373626373626
224	Sc_chr04	88433	88483	50	0.46
225	Sc_chr04	88483	89506	1023	0.3870967741935484
226	Sc_chr04	89506	90083	577	0.37088388214904683
227	Sc_chr04	90083	90979	896	0.36049107142857145
228	Sc_chr04	90979	91123	144	0.3819444444444444
229	Sc_chr04	91123	91441	318	0.34905660377358494
230	Sc_chr04	91441	92328	887	0.3472378804960541
231	Sc_chr04	92328	92744	416	0.2548076923076923
232	Sc_chr04	92744	93054	310	0.36451612903225805
233	Sc_chr04	93054	93326	272	0.41544117647058826
234	Sc_chr04	93326	93423	97	0.4845360824742268
235	Sc_chr04	93423	93499	76	0.5263157894736842
236	Sc_chr04	93499	93522	23	0.43478260869565216
237	Sc_chr04	93522	93664	142	0.4154929577464789
238	Sc_chr04	93664	94531	867	0.3829296424452134
239	Sc_chr04	94531	94765	234	0.4188034188034188
240	Sc_chr04	94765	94804	39	0.28205128205128205
241	Sc_chr04	94804	94949	145	0.4689655172413793
242	Sc_chr04	94949	95171	222	0.40540540540540543
243	Sc_chr04	95171	95546	375	0.4026666666666667
244	Sc_chr04	95546	95654	108	0.4074074074074074
245	Sc_chr04	95654	96161	507	0.32938856015779094
246	Sc_chr04	96161	96806	645	0.40310077519379844
247	Sc_chr04	96806	98711	1905	0.39265091863517054
248	Sc_chr04	98711	99213	502	0.4223107569721115
249	Sc_chr04	99213	99584	371	0.3018867924528302
250	Sc_chr04	99584	99655	71	0.40845070422535207
251	Sc_chr04	99655	99691	36	0.38888888888888884
252	Sc_chr04	99691	99749	58	0.4310344827586207
253	Sc_chr04	99749	99917	168	0.4404761904761905
254	Sc_chr04	99917	100109	192	0.359375
255	Sc_chr04	100109	100663	554	0.3628158844765343
256	Sc_chr04	100663	101081	418	0.37559808612440193
257	Sc_chr04	101081	101372	291	0.37800687285223367
258	Sc_chr04	101372	103073	1701	0.38095238095238093
259	Sc_chr04	103073	103873	800	0.385
260	Sc_chr04	103873	104171	298	0.4530201342281879
261	Sc_chr04	104171	104186	15	0.7333333333333333
262	Sc_chr04	104186	104376	190	0.39473684210526316
263	Sc_chr04	104376	104743	367	0.38964577656675753
264	Sc_chr04	104743	104891	148	0.45945945945945943
265	Sc_chr04	104891	105020	129	0.4263565891472868
266	Sc_chr04	105020	105512	492	0.45121951219512196
267	Sc_chr04	105512	106236	724	0.4088397790055249
268	Sc_chr04	106236	106433	197	0.45685279187817257
269	Sc_chr04	106433	106533	100	0.47
270	Sc_chr04	106533	106669	136	0.42647058823529416
271	Sc_chr04	106669	106876	207	0.4009661835748792
272	Sc_chr04	106876	106981	105	0.4095238095238095
273	Sc_chr04	106981	107031	50	0.44
274	Sc_chr04	107031	107906	875	0.4308571428571429
275	Sc_chr04	107906	107920	14	0.42857142857142855
276	Sc_chr04	107920	108829	909	0.4004400440044005
277	Sc_chr04	108829	108897	68	0.338235294117647
278	Sc_chr04	108897	109122	225	0.3688888888888889
279	Sc_chr04	109122	110711	1589	0.44493392070484583
280	Sc_chr04	110711	111150	439	0.357630979498861
281	Sc_chr04	111150	111424	274	0.37591240875912413
282	Sc_chr04	111424	111582	158	0.310126582278481
283	Sc_chr04	111582	111696	114	0.4298245614035088
284	Sc_chr04	111696	111929	233	0.40343347639484983
285	Sc_chr04	111929	113026	1097	0.3965360072926163
286	Sc_chr04	113026	113322	296	0.3682432432432432
287	Sc_chr04	113322	113433	111	0.33333333333333337
288	Sc_chr04	113433	114403	970	0.39381443298969077
289	Sc_chr04	114403	114682	279	0.3763440860215054
290	Sc_chr04	114682	114736	54	0.38888888888888884
291	Sc_chr04	114736	115520	784	0.37882653061224486
292	Sc_chr04	115520	116189	669	0.3557548579970105
293	Sc_chr04	116189	116543	354	0.3559322033898305
294	Sc_chr04	116543	116609	66	0.37878787878787873
295	Sc_chr04	116609	116881	272	0.400735294117647
296	Sc_chr04	116881	116959	78	0.3205128205128205
297	Sc_chr04	116959	117296	337	0.3115727002967359
298	Sc_chr04	117296	117718	422	0.3744075829383886
299	Sc_chr04	117718	117952	234	0.3547008547008547
300	Sc_chr04	117952	118282	330	0.3242424242424242
301	Sc_chr04	118282	118856	574	0.3466898954703833
302	Sc_chr04	118856	118903	47	0.3829787234042554
303	Sc_chr04	118903	118930	27	0.33333333333333337
304	Sc_chr04	118930	118966	36	0.41666666666666663
305	Sc_chr04	118966	119106	140	0.37142857142857144
306	Sc_chr04	119106	119603	497	0.4225352112676056
307	Sc_chr04	119603	119922	319	0.3448275862068966
308	Sc_chr04	119922	120136	214	0.3925233644859813
309	Sc_chr04	120136	120201	65	0.4
310	Sc_chr04	120201	120366	165	0.3818181818181818
311	Sc_chr04	120366	120581	215	0.3441860465116279
312	Sc_chr04	120581	120694	113	0.3097345132743363
313	Sc_chr04	120694	120845	151	0.3642384105960265
314	Sc_chr04	120845	121318	473	0.3551797040169133
315	Sc_chr04	121318	121552	234	0.4017094017094017
316	Sc_chr04	121552	121592	40	0.4
317	Sc_chr04	121592	121827	235	0.3446808510638298
318	Sc_chr04	121827	123404	1577	0.39315155358275206
319	Sc_chr04	123404	123923	519	0.3179190751445087
320	Sc_chr04	123923	124187	264	0.42045454545454547
321	Sc_chr04	124187	124259	72	0.41666666666666663
322	Sc_chr04	124259	124349	90	0.4
323	Sc_chr04	124349	124814	465	0.4086021505376344
324	Sc_chr04	124814	124952	138	0.42028985507246375
325	Sc_chr04	124952	125916	964	0.3858921161825726
326	Sc_chr04	125916	125921	5	0.6
327	Sc_chr04	125921	126089	168	0.4345238095238095
328	Sc_chr04	126089	127236	1147	0.4019180470793374
329	Sc_chr04	127236	127318	82	0.3780487804878049
330	Sc_chr04	127318	128121	803	0.4259028642590287
331	Sc_chr04	128121	128955	834	0.3920863309352518
332	Sc_chr04	128955	129183	228	0.41228070175438597
333	Sc_chr04	129183	129279	96	0.41666666666666663
334	Sc_chr04	129279	129363	84	0.4761904761904762
335	Sc_chr04	129363	129423	60	0.55
336	Sc_chr04	129423	129597	174	0.3563218390804597
337	Sc_chr04	129597	130299	702	0.33760683760683763
338	Sc_chr04	130299	130413	114	0.27192982456140347
339	Sc_chr04	130413	130706	293	0.4129692832764505
340	Sc_chr04	130706	130960	254	0.35826771653543305
341	Sc_chr04	130960	131599	639	0.38497652582159625
342	Sc_chr04	131599	131712	113	0.3185840707964602
343	Sc_chr04	131712	132395	683	0.37920937042459735
344	Sc_chr04	132395	132704	309	0.38187702265372164
345	Sc_chr04	132704	132730	26	0.5384615384615384
346	Sc_chr04	132730	132801	71	0.45070422535211263
347	Sc_chr04	132801	132978	177	0.39548022598870053
348	Sc_chr04	132978	133004	26	0.2692307692307692
349	Sc_chr04	133004	133573	569	0.3954305799648506
350	Sc_chr04	133573	133696	123	0.4227642276422764
351	Sc_chr04	133696	133916	220	0.42272727272727273
352	Sc_chr04	133916	133925	9	0.4444444444444444
353	Sc_chr04	133925	133957	32	0.28125
354	Sc_chr04	133957	134026	69	0.4492753623188406
355	Sc_chr04	134026	134257	231	0.45454545454545453
356	Sc_chr04	134257	134562	305	0.4590163934426229
357	Sc_chr04	134562	136042	1480	0.39797297297297296
358	Sc_chr04	136042	136249	207	0.35265700483091783
359	Sc_chr04	136249	136266	17	0.5882352941176471
360	Sc_chr04	136266	136393	127	0.4015748031496063
361	Sc_chr04	136393	137777	1384	0.3684971098265896
362	Sc_chr04	137777	138188	411	0.3795620437956205
363	Sc_chr04	138188	139713	1525	0.3632786885245902
364	Sc_chr04	139713	139776	63	0.28571428571428575
365	Sc_chr04	139776	140097	321	0.33956386292834895
366	Sc_chr04	140097	140274	177	0.4632768361581921
367	Sc_chr04	140274	140574	300	0.39333333333333337
368	Sc_chr04	140574	141075	501	0.41317365269461076
369	Sc_chr04	141075	141923	848	0.3608490566037736
370	Sc_chr04	141923	142186	263	0.3612167300380228
371	Sc_chr04	142186	142476	290	0.3793103448275862
372	Sc_chr04	142476	142754	278	0.36330935251798563
373	Sc_chr04	142754	142901	147	0.40816326530612246
374	Sc_chr04	142901	143563	662	0.36858006042296076
375	Sc_chr04	143563	144100	537	0.3463687150837989
376	Sc_chr04	144100	144785	685	0.3343065693430657
377	Sc_chr04	144785	144827	42	0.4523809523809524
378	Sc_chr04	144827	144973	146	0.3904109589041096
379	Sc_chr04	144973	145250	277	0.3898916967509025
380	Sc_chr04	145250	145657	407	0.4201474201474201
381	Sc_chr04	145657	145854	197	0.3147208121827411
382	Sc_chr04	145854	146134	280	0.44642857142857145
383	Sc_chr04	146134	146399	265	0.41886792452830185
384	Sc_chr04	146399	146473	74	0.4324324324324324
385	Sc_chr04	146473	147268	795	0.45534591194968554
386	Sc_chr04	147268	147340	72	0.45833333333333337
387	Sc_chr04	147340	147515	175	0.45142857142857146
388	Sc_chr04	147515	147613	98	0.4489795918367347
389	Sc_chr04	147613	147771	158	0.41139240506329117
390	Sc_chr04	147771	148430	659	0.48861911987860396
391	Sc_chr04	148430	148446	16	0.625
392	Sc_chr04	148446	148495	49	0.4489795918367347
393	Sc_chr04	148495	149172	677	0.3810930576070901
394	Sc_chr04	149172	149472	300	0.4033333333333334
395	Sc_chr04	149472	149526	54	0.4074074074074074
396	Sc_chr04	149526	149883	357	0.46498599439775906
397	Sc_chr04	149883	149906	23	0.34782608695652173
398	Sc_chr04	149906	150119	213	0.38028169014084506
399	Sc_chr04	150119	150199	80	0.425
400	Sc_chr04	150199	150671	472	0.4216101694915254
401	Sc_chr04	150671	150702	31	0.4838709677419355
402	Sc_chr04	150702	150907	205	0.351219512195122
403	Sc_chr04	150907	151061	154	0.36363636363636365
404	Sc_chr04	151061	151092	31	0.4516129032258065
405	Sc_chr04	151092	151667	575	0.40347826086956523
406	Sc_chr04	151667	151712	45	0.4
407	Sc_chr04	151712	151962	250	0.396
408	Sc_chr04	151962	152027	65	0.35384615384615387
409	Sc_chr04	152027	152333	306	0.4084967320261438
410	Sc_chr04	152333	152677	344	0.4273255813953488
411	Sc_chr04	152677	153624	947	0.3907074973600844
412	Sc_chr04	153624	153821	197	0.37055837563451777
413	Sc_chr04	153821	155291	1470	0.38299319727891157
414	Sc_chr04	155291	155297	6	0.33333333333333337
415	Sc_chr04	155297	155609	312	0.4230769230769231
416	Sc_chr04	155609	156379	770	0.33116883116883117
417	Sc_chr04	156379	156517	138	0.38405797101449274
418	Sc_chr04	156517	157051	534	0.41947565543071164
419	Sc_chr04	157051	157222	171	0.39766081871345027
420	Sc_chr04	157222	157253	31	0.3870967741935484
421	Sc_chr04	157253	157668	415	0.3566265060240964
422	Sc_chr04	157668	158389	721	0.39251040221914013
423	Sc_chr04	158389	158525	136	0.38235294117647056
424	Sc_chr04	158525	159780	1255	0.3609561752988048
425	Sc_chr04	159780	159873	93	0.5053763440860215
426	Sc_chr04	159873	160098	225	0.4222222222222222
427	Sc_chr04	160098	160271	173	0.5028901734104047
428	Sc_chr04	160271	160365	94	0.3404255319148936
429	Sc_chr04	160365	160600	235	0.425531914893617
430	Sc_chr04	160600	161728	1128	0.33333333333333337
431	Sc_chr04	161728	161919	191	0.44502617801047123
432	Sc_chr04	161919	162228	309	0.3980582524271845
433	Sc_chr04	162228	162304	76	0.39473684210526316
434	Sc_chr04	162304	163096	792	0.375
435	Sc_chr04	163096	163679	583	0.37907375643224694
436	Sc_chr04	163679	164433	754	0.3687002652519894
437	Sc_chr04	164433	164736	303	0.44554455445544555
438	Sc_chr04	164736	164785	49	0.42857142857142855
439	Sc_chr04	164785	165025	240	0.33333333333333337
440	Sc_chr04	165025	165250	225	0.4177777777777778
441	Sc_chr04	165250	165423	173	0.4682080924855492
442	Sc_chr04	165423	165816	393	0.3816793893129771
443	Sc_chr04	165816	166340	524	0.37786259541984735
444	Sc_chr04	166340	166393	53	0.3584905660377358
445	Sc_chr04	166393	166833	440	0.3795454545454545
446	Sc_chr04	166833	167678	845	0.41775147928994083
447	Sc_chr04	167678	167732	54	0.4074074074074074
448	Sc_chr04	167732	167961	229	0.4148471615720524
449	Sc_chr04	167961	168061	100	0.41
450	Sc_chr04	168061	168919	858	0.4125874125874126
451	Sc_chr04	168919	169233	314	0.3821656050955414
452	Sc_chr04	169233	170356	1123	0.30365093499554763
453	Sc_chr04	170356	170756	400	0.45
454	Sc_chr04	170756	170809	53	0.41509433962264153
455	Sc_chr04	170809	171374	565	0.3451327433628319
456	Sc_chr04	171374	171573	199	0.41708542713567837
457	Sc_chr04	171573	171872	299	0.3812709030100334
458	Sc_chr04	171872	171878	6	0.5
459	Sc_chr04	171878	172311	433	0.30484988452655887
460	Sc_chr04	172311	172438	127	0.41732283464566927
461	Sc_chr04	172438	172993	555	0.4216216216216216
462	Sc_chr04	172993	173434	441	0.35374149659863946
463	Sc_chr04	173434	173457	23	0.30434782608695654
464	Sc_chr04	173457	173658	201	0.36318407960199006
465	Sc_chr04	173658	173869	211	0.4170616113744076
466	Sc_chr04	173869	174014	145	0.3103448275862069
467	Sc_chr04	174014	174869	855	0.3543859649122807
468	Sc_chr04	174869	175128	259	0.37065637065637064
469	Sc_chr04	175128	175286	158	0.3987341772151899
470	Sc_chr04	175286	175291	5	0.4
471	Sc_chr04	175291	175427	136	0.375
472	Sc_chr04	175427	175921	494	0.4149797570850203
473	Sc_chr04	175921	175971	50	0.52
474	Sc_chr04	175971	176183	212	0.4245283018867924
475	Sc_chr04	176183	176623	440	0.4454545454545455
476	Sc_chr04	176623	176642	19	0.4736842105263158
477	Sc_chr04	176642	176866	224	0.35267857142857145
478	Sc_chr04	176866	177060	194	0.44845360824742264
479	Sc_chr04	177060	177228	168	0.42857142857142855
480	Sc_chr04	177228	177392	164	0.40853658536585363
481	Sc_chr04	177392	178001	609	0.39737274220032837
482	Sc_chr04	178001	178045	44	0.4318181818181818
483	Sc_chr04	178045	178630	585	0.3658119658119658
484	Sc_chr04	178630	179065	435	0.37471264367816093
485	Sc_chr04	179065	179664	599	0.3522537562604341
486	Sc_chr04	179664	179856	192	0.34895833333333337
487	Sc_chr04	179856	180727	871	0.3536165327210103
488	Sc_chr04	180727	180774	47	0.4042553191489362
489	Sc_chr04	180774	180976	202	0.38613861386138615
490	Sc_chr04	180976	181745	769	0.3602080624187256
491	Sc_chr04	181745	183185	1440	0.37430555555555556
492	Sc_chr04	183185	183406	221	0.3665158371040724
493	Sc_chr04	183406	183916	510	0.44313725490196076
494	Sc_chr04	183916	184122	206	0.44174757281553395
495	Sc_chr04	184122	184197	75	0.42666666666666664
496	Sc_chr04	184197	186226	2029	0.378018728437654
497	Sc_chr04	186226	186632	406	0.3472906403940887
498	Sc_chr04	186632	186754	122	0.3442622950819672
499	Sc_chr04	186754	186812	58	0.3448275862068966
500	Sc_chr04	186812	186850	38	0.368421052631579
501	Sc_chr04	186850	186890	40	0.35
502	Sc_chr04	186890	187741	851	0.38072855464159816
503	Sc_chr04	187741	188398	657	0.3363774733637747
504	Sc_chr04	188398	188695	297	0.3434343434343435
505	Sc_chr04	188695	188754	59	0.4067796610169491
506	Sc_chr04	188754	189094	340	0.34705882352941175
507	Sc_chr04	189094	189218	124	0.3387096774193548
508	Sc_chr04	189218	189391	173	0.31213872832369943
509	Sc_chr04	189391	189418	27	0.2222222222222222
510	Sc_chr04	189418	189505	87	0.3448275862068966
511	Sc_chr04	189505	189649	144	0.3680555555555556
512	Sc_chr04	189649	189790	141	0.3900709219858156
513	Sc_chr04	189790	189883	93	0.3763440860215054
514	Sc_chr04	189883	190247	364	0.3818681318681319
515	Sc_chr04	190247	190316	69	0.391304347826087
516	Sc_chr04	190316	190354	38	0.4473684210526316
517	Sc_chr04	190354	190465	111	0.38738738738738737
518	Sc_chr04	190465	190592	127	0.4094488188976378
519	Sc_chr04	190592	190768	176	0.34659090909090906
520	Sc_chr04	190768	190991	223	0.3811659192825112
521	Sc_chr04	190991	191073	82	0.4146341463414634
522	Sc_chr04	191073	191112	39	0.4615384615384615
523	Sc_chr04	191112	192293	1181	0.35139712108382726
524	Sc_chr04	192293	192758	465	0.2817204301075269
525	Sc_chr04	192758	192935	177	0.33333333333333337
526	Sc_chr04	192935	193558	623	0.3499197431781702
527	Sc_chr04	193558	194606	1048	0.36641221374045796
528	Sc_chr04	194606	194749	143	0.3356643356643357
529	Sc_chr04	194749	195241	492	0.38211382113821135
530	Sc_chr04	195241	195461	220	0.4454545454545455
531	Sc_chr04	195461	195758	297	0.4242424242424242
532	Sc_chr04	195758	195927	169	0.4674556213017752
533	Sc_chr04	195927	196384	457	0.3610503282275711
534	Sc_chr04	196384	196776	392	0.3494897959183673
535	Sc_chr04	196776	197203	427	0.38875878220140514
536	Sc_chr04	197203	197332	129	0.3798449612403101
537	Sc_chr04	197332	197372	40	0.45
538	Sc_chr04	197372	197720	348	0.4281609195402299
539	Sc_chr04	197720	197846	126	0.42857142857142855
540	Sc_chr04	197846	198179	333	0.4444444444444444
541	Sc_chr04	198179	198482	303	0.3432343234323432
542	Sc_chr04	198482	198958	476	0.42857142857142855
543	Sc_chr04	198958	199200	242	0.5247933884297521
544	Sc_chr04	199200	199258	58	0.5344827586206897
545	Sc_chr04	199258	199268	10	0.4
546	Sc_chr04	199268	199631	363	0.465564738292011
547	Sc_chr04	199631	200285	654	0.4510703363914373
548	Sc_chr04	200285	200383	98	0.5102040816326531
549	Sc_chr04	200383	200780	397	0.4030226700251889
550	Sc_chr04	200780	201050	270	0.37407407407407406
551	Sc_chr04	201050	201149	99	0.3939393939393939
552	Sc_chr04	201149	201451	302	0.41721854304635764
553	Sc_chr04	201451	201705	254	0.3346456692913386
554	Sc_chr04	201705	201902	197	0.36548223350253806
555	Sc_chr04	201902	202156	254	0.421259842519685
556	Sc_chr04	202156	202182	26	0.3846153846153846
557	Sc_chr04	202182	202428	246	0.3780487804878049
558	Sc_chr04	202428	202793	365	0.3780821917808219
559	Sc_chr04	202793	203006	213	0.3568075117370892
560	Sc_chr04	203006	203078	72	0.3472222222222222
561	Sc_chr04	203078	203215	137	0.437956204379562
562	Sc_chr04	203215	203553	338	0.4319526627218935
563	Sc_chr04	203553	204255	702	0.39173789173789175
564	Sc_chr04	204255	204495	240	0.44166666666666665
565	Sc_chr04	204495	204624	129	0.4186046511627907
566	Sc_chr04	204624	204931	307	0.34527687296416937
567	Sc_chr04	204931	205420	489	0.33946830265848665
568	Sc_chr04	205420	206111	691	0.49493487698986977
569	Sc_chr04	206111	206226	115	0.4260869565217391
570	Sc_chr04	206226	206386	160	0.40625
571	Sc_chr04	206386	206789	403	0.3870967741935484
572	Sc_chr04	206789	206850	61	0.4590163934426229
573	Sc_chr04	206850	206966	116	0.3620689655172413
574	Sc_chr04	206966	207089	123	0.38211382113821135
575	Sc_chr04	207089	207095	6	0.5
576	Sc_chr04	207095	207154	59	0.3559322033898305
577	Sc_chr04	207154	207159	5	0.4
578	Sc_chr04	207159	207179	20	0.4
579	Sc_chr04	207179	207638	459	0.41612200435729846
580	Sc_chr04	207638	207743	105	0.3523809523809524
581	Sc_chr04	207743	207811	68	0.35294117647058826
582	Sc_chr04	207811	207833	22	0.5
583	Sc_chr04	207833	208217	384	0.39322916666666663
584	Sc_chr04	208217	208928	711	0.3952180028129395
585	Sc_chr04	208928	209240	312	0.38141025641025644
586	Sc_chr04	209240	209402	162	0.42592592592592593
587	Sc_chr04	209402	209492	90	0.37777777777777777
588	Sc_chr04	209492	210089	597	0.4036850921273032
589	Sc_chr04	210089	210374	285	0.35789473684210527
590	Sc_chr04	210374	210862	488	0.32377049180327866
591	Sc_chr04	210862	210948	86	0.32558139534883723
592	Sc_chr04	210948	211020	72	0.2638888888888889
593	Sc_chr04	211020	212111	1091	0.39780018331805683
594	Sc_chr04	212111	212291	180	0.36666666666666664
595	Sc_chr04	212291	212515	224	0.2901785714285714
596	Sc_chr04	212515	213265	750	0.3586666666666667
597	Sc_chr04	213265	213530	265	0.41132075471698115
598	Sc_chr04	213530	213630	100	0.5
599	Sc_chr04	213630	213964	334	0.4311377245508982
600	Sc_chr04	213964	213979	15	0.5333333333333333
601	Sc_chr04	213979	214288	309	0.4336569579288026
602	Sc_chr04	214288	214295	7	0.42857142857142855
603	Sc_chr04	214295	214592	297	0.38047138047138046
604	Sc_chr04	214592	214806	214	0.4392523364485982
605	Sc_chr04	214806	214893	87	0.45977011494252873
606	Sc_chr04	214893	215237	344	0.39825581395348836
607	Sc_chr04	215237	215660	423	0.42080378250591016
608	Sc_chr04	215660	215853	193	0.3264248704663213
609	Sc_chr04	215853	215950	97	0.422680412371134
610	Sc_chr04	215950	216004	54	0.42592592592592593
611	Sc_chr04	216004	216287	283	0.4275618374558304
612	Sc_chr04	216287	216751	464	0.39224137931034486
613	Sc_chr04	216751	216817	66	0.37878787878787873
614	Sc_chr04	216817	217756	939	0.3748668796592119
615	Sc_chr04	217756	218132	376	0.3457446808510638
616	Sc_chr04	218132	218458	326	0.36196319018404904
617	Sc_chr04	218458	218516	58	0.25862068965517243
618	Sc_chr04	218516	218851	335	0.3641791044776119
619	Sc_chr04	218851	218861	10	0.4
620	Sc_chr04	218861	219032	171	0.32748538011695905
621	Sc_chr04	219032	219233	201	0.37810945273631835
622	Sc_chr04	219233	219416	183	0.36612021857923494
623	Sc_chr04	219416	219437	21	0.33333333333333337
624	Sc_chr04	219437	219471	34	0.5
625	Sc_chr04	219471	219891	420	0.35952380952380947
626	Sc_chr04	219891	220056	165	0.47878787878787876
627	Sc_chr04	220056	220146	90	0.34444444444444444
628	Sc_chr04	220146	220611	465	0.40645161290322585
629	Sc_chr04	220611	220692	81	0.3950617283950617
630	Sc_chr04	220692	221586	894	0.32997762863534674
631	Sc_chr04	221586	221730	144	0.3125
632	Sc_chr04	221730	222495	765	0.3686274509803921
633	Sc_chr04	222495	222522	27	0.2592592592592593
634	Sc_chr04	222522	223309	787	0.38754764930114355
635	Sc_chr04	223309	223685	376	0.40691489361702127
636	Sc_chr04	223685	224322	637	0.3500784929356358
637	Sc_chr04	224322	224801	479	0.35490605427974947
638	Sc_chr04	224801	224924	123	0.36585365853658536
639	Sc_chr04	224924	225119	195	0.3384615384615385
640	Sc_chr04	225119	225163	44	0.34090909090909094
641	Sc_chr04	225163	225579	416	0.3605769230769231
642	Sc_chr04	225579	225892	313	0.3706070287539936
643	Sc_chr04	225892	225959	67	0.40298507462686567
644	Sc_chr04	225959	226772	813	0.4083640836408364
645	Sc_chr04	226772	227005	233	0.33476394849785407
646	Sc_chr04	227005	227037	32	0.4375
647	Sc_chr04	227037	227182	145	0.4896551724137931
648	Sc_chr04	227182	227694	512	0.38671875
649	Sc_chr04	227694	227914	220	0.42727272727272725
650	Sc_chr04	227914	227923	9	0.4444444444444444
651	Sc_chr04	227923	227955	32	0.28125
652	Sc_chr04	227955	228024	69	0.4492753623188406
653	Sc_chr04	228024	228233	209	0.4688995215311004
654	Sc_chr04	228233	228255	22	0.36363636363636365
655	Sc_chr04	228255	228511	256	0.44140625
656	Sc_chr04	228511	228910	399	0.3558897243107769
657	Sc_chr04	228910	228982	72	0.38888888888888884
658	Sc_chr04	228982	229002	20	0.3
659	Sc_chr04	229002	230226	1224	0.37254901960784315
660	Sc_chr04	230226	230246	20	0.35
661	Sc_chr04	230246	231347	1101	0.4250681198910082
662	Sc_chr04	231347	232456	1109	0.35978358881875566
663	Sc_chr04	232456	233436	980	0.4142857142857143
664	Sc_chr04	233436	233596	160	0.41875
665	Sc_chr04	233596	233679	83	0.46987951807228917
666	Sc_chr04	233679	234001	322	0.3354037267080745
667	Sc_chr04	234001	234340	339	0.31563421828908556
668	Sc_chr04	234340	234667	327	0.40672782874617736
669	Sc_chr04	234667	234749	82	0.475609756097561
670	Sc_chr04	234749	234877	128	0.3125
671	Sc_chr04	234877	235093	216	0.38425925925925924
672	Sc_chr04	235093	235158	65	0.4
673	Sc_chr04	235158	235587	429	0.4009324009324009
674	Sc_chr04	235587	235765	178	0.3820224719101124
675	Sc_chr04	235765	236419	654	0.3379204892966361
676	Sc_chr04	236419	236713	294	0.41496598639455784
677	Sc_chr04	236713	236743	30	0.43333333333333335
678	Sc_chr04	236743	236752	9	0.2222222222222222
679	Sc_chr04	236752	237365	613	0.4257748776508972
680	Sc_chr04	237365	237541	176	0.45454545454545453
681	Sc_chr04	237541	237571	30	0.4
682	Sc_chr04	237571	237618	47	0.36170212765957444
683	Sc_chr04	237618	238265	647	0.4142194744976816
684	Sc_chr04	238265	238415	150	0.4
685	Sc_chr04	238415	238760	345	0.4115942028985507
686	Sc_chr04	238760	239411	651	0.42396313364055305
687	Sc_chr04	239411	239697	286	0.3846153846153846
688	Sc_chr04	239697	240082	385	0.4597402597402598
689	Sc_chr04	240082	240443	361	0.37119113573407203
690	Sc_chr04	240443	240606	163	0.42944785276073616
691	Sc_chr04	240606	240833	227	0.4185022026431718
692	Sc_chr04	240833	241505	672	0.40625
693	Sc_chr04	241505	241909	404	0.4678217821782178
694	Sc_chr04	241909	241990	81	0.3703703703703704
695	Sc_chr04	241990	242032	42	0.5
696	Sc_chr04	242032	242361	329	0.331306990881459
697	Sc_chr04	242361	242466	105	0.3142857142857143
698	Sc_chr04	242466	242826	360	0.31666666666666665
699	Sc_chr04	242826	243163	337	0.3857566765578635
700	Sc_chr04	243163	243463	300	0.37666666666666665
701	Sc_chr04	243463	243789	326	0.3834355828220859
702	Sc_chr04	243789	243977	188	0.3404255319148936
703	Sc_chr04	243977	243988	11	0.36363636363636365
704	Sc_chr04	243988	244294	306	0.3758169934640523
705	Sc_chr04	244294	244389	95	0.4210526315789474
706	Sc_chr04	244389	244479	90	0.35555555555555557
707	Sc_chr04	244479	244492	13	0.3076923076923077
708	Sc_chr04	244492	245260	768	0.35677083333333337
709	Sc_chr04	245260	245383	123	0.4471544715447155
710	Sc_chr04	245383	245407	24	0.25
711	Sc_chr04	245407	245650	243	0.3744855967078189
712	Sc_chr04	245650	245718	68	0.36764705882352944
713	Sc_chr04	245718	245794	76	0.35526315789473684
714	Sc_chr04	245794	247567	1773	0.3852227862380147
715	Sc_chr04	247567	248155	588	0.37755102040816324
716	Sc_chr04	248155	248174	19	0.4210526315789474
717	Sc_chr04	248174	248343	169	0.2958579881656805
718	Sc_chr04	248343	249475	1132	0.36130742049469966
719	Sc_chr04	249475	249812	337	0.3857566765578635
720	Sc_chr04	249812	250367	555	0.35855855855855856
721	Sc_chr04	250367	250470	103	0.36893203883495146
722	Sc_chr04	250470	250577	107	0.2803738317757009
723	Sc_chr04	250577	250892	315	0.41904761904761906
724	Sc_chr04	250892	251109	217	0.41013824884792627
725	Sc_chr04	251109	251183	74	0.48648648648648646
726	Sc_chr04	251183	251826	643	0.36080870917573876
727	Sc_chr04	251826	251832	6	0.33333333333333337
728	Sc_chr04	251832	252093	261	0.32567049808429116
729	Sc_chr04	252093	252194	101	0.31683168316831684
730	Sc_chr04	252194	252417	223	0.44843049327354256
731	Sc_chr04	252417	253296	879	0.36177474402730375
732	Sc_chr04	253296	253454	158	0.31645569620253167
733	Sc_chr04	253454	253601	147	0.35374149659863946
734	Sc_chr04	253601	253710	109	0.3577981651376147
735	Sc_chr04	253710	253744	34	0.5294117647058824
736	Sc_chr04	253744	254233	489	0.3169734151329243
737	Sc_chr04	254233	254271	38	0.5263157894736842
738	Sc_chr04	254271	254382	111	0.3963963963963964
739	Sc_chr04	254382	254470	88	0.3977272727272727
740	Sc_chr04	254470	254723	253	0.32015810276679846
741	Sc_chr04	254723	254845	122	0.4180327868852459
742	Sc_chr04	254845	255921	1076	0.3689591078066915
743	Sc_chr04	255921	256013	92	0.30434782608695654
744	Sc_chr04	256013	256564	551	0.3901996370235935
745	Sc_chr04	256564	256877	313	0.2971246006389776
746	Sc_chr04	256877	257154	277	0.332129963898917
747	Sc_chr04	257154	257579	425	0.3764705882352941
748	Sc_chr04	257579	257669	90	0.37777777777777777
749	Sc_chr04	257669	257816	147	0.3401360544217687
750	Sc_chr04	257816	258421	605	0.4099173553719008
751	Sc_chr04	258421	258730	309	0.4077669902912621
752	Sc_chr04	258730	259865	1135	0.36563876651982374
753	Sc_chr04	259865	260404	539	0.35435992578849723
754	Sc_chr04	260404	260492	88	0.36363636363636365
755	Sc_chr04	260492	260597	105	0.3523809523809524
756	Sc_chr04	260597	261413	816	0.3455882352941177
757	Sc_chr04	261413	261454	41	0.34146341463414637
758	Sc_chr04	261454	261468	14	0.42857142857142855
759	Sc_chr04	261468	261570	102	0.4019607843137255
760	Sc_chr04	261570	261839	269	0.33828996282527884
761	Sc_chr04	261839	262006	167	0.3532934131736527
762	Sc_chr04	262006	262151	145	0.3448275862068966
763	Sc_chr04	262151	262370	219	0.3561643835616438
764	Sc_chr04	262370	262466	96	0.39583333333333337
765	Sc_chr04	262466	262724	258	0.41472868217054265
766	Sc_chr04	262724	263068	344	0.38372093023255816
767	Sc_chr04	263068	263155	87	0.40229885057471265
768	Sc_chr04	263155	263160	5	0.4
769	Sc_chr04	263160	263328	168	0.3035714285714286
770	Sc_chr04	263328	263427	99	0.41414141414141414
771	Sc_chr04	263427	263905	478	0.40376569037656906
772	Sc_chr04	263905	263970	65	0.4
773	Sc_chr04	263970	264925	955	0.406282722513089
774	Sc_chr04	264925	265015	90	0.33333333333333337
775	Sc_chr04	265015	265343	328	0.4481707317073171
776	Sc_chr04	265343	265350	7	0.5714285714285715
777	Sc_chr04	265350	265716	366	0.4808743169398907
778	Sc_chr04	265716	265754	38	0.4473684210526316
779	Sc_chr04	265754	265976	222	0.42792792792792794
780	Sc_chr04	265976	266946	970	0.3876288659793814
781	Sc_chr04	266946	267048	102	0.37254901960784315
782	Sc_chr04	267048	267888	840	0.35952380952380947
783	Sc_chr04	267888	268042	154	0.35714285714285715
784	Sc_chr04	268042	268162	120	0.39166666666666666
785	Sc_chr04	268162	268411	249	0.4136546184738956
786	Sc_chr04	268411	268910	499	0.3587174348697395
787	Sc_chr04	268910	269982	1072	0.3572761194029851
788	Sc_chr04	269982	270316	334	0.29940119760479045
789	Sc_chr04	270316	270514	198	0.38888888888888884
790	Sc_chr04	270514	270520	6	0.33333333333333337
791	Sc_chr04	270520	270632	112	0.4017857142857143
792	Sc_chr04	270632	270644	12	0.41666666666666663
793	Sc_chr04	270644	270823	179	0.33519553072625696
794	Sc_chr04	270823	270870	47	0.3404255319148936
795	Sc_chr04	270870	271085	215	0.32558139534883723
796	Sc_chr04	271085	271429	344	0.3546511627906977
797	Sc_chr04	271429	271564	135	0.4074074074074074
798	Sc_chr04	271564	271795	231	0.41558441558441556
799	Sc_chr04	271795	271876	81	0.345679012345679
800	Sc_chr04	271876	272177	301	0.38205980066445183
801	Sc_chr04	272177	273185	1008	0.376984126984127
802	Sc_chr04	273185	273346	161	0.36024844720496896
803	Sc_chr04	273346	273380	34	0.29411764705882354
804	Sc_chr04	273380	273778	398	0.364321608040201
805	Sc_chr04	273778	274228	450	0.35333333333333333
806	Sc_chr04	274228	274317	89	0.3820224719101124
807	Sc_chr04	274317	274551	234	0.44017094017094016
808	Sc_chr04	274551	275007	456	0.38815789473684215
809	Sc_chr04	275007	275554	547	0.3546617915904936
810	Sc_chr04	275554	276146	592	0.39695945945945943
811	Sc_chr04	276146	276225	79	0.379746835443038
812	Sc_chr04	276225	276592	367	0.4359673024523161
813	Sc_chr04	276592	276648	56	0.44642857142857145
814	Sc_chr04	276648	276785	137	0.3357664233576642
815	Sc_chr04	276785	276884	99	0.30303030303030304
816	Sc_chr04	276884	276909	25	0.48
817	Sc_chr04	276909	276964	55	0.4181818181818182
818	Sc_chr04	276964	277384	420	0.3976190476190476
819	Sc_chr04	277384	277879	495	0.4
820	Sc_chr04	277879	278050	171	0.4093567251461988
821	Sc_chr04	278050	278257	207	0.35265700483091783
822	Sc_chr04	278257	278294	37	0.2972972972972973
823	Sc_chr04	278294	278371	77	0.41558441558441556
824	Sc_chr04	278371	278908	537	0.37243947858473
825	Sc_chr04	278908	278926	18	0.4444444444444444
826	Sc_chr04	278926	279208	282	0.3723404255319149
827	Sc_chr04	279208	279634	426	0.37089201877934275
828	Sc_chr04	279634	279691	57	0.368421052631579
829	Sc_chr04	279691	280546	855	0.3461988304093568
830	Sc_chr04	280546	280578	32	0.46875
831	Sc_chr04	280578	280638	60	0.38333333333333336
832	Sc_chr04	280638	280993	355	0.38309859154929576
833	Sc_chr04	280993	282335	1342	0.36438152011922503
834	Sc_chr04	282335	282479	144	0.33333333333333337
835	Sc_chr04	282479	282827	348	0.42241379310344823
836	Sc_chr04	282827	282908	81	0.49382716049382713
837	Sc_chr04	282908	283004	96	0.40625
838	Sc_chr04	283004	283014	10	0.4
839	Sc_chr04	283014	283190	176	0.3806818181818182
840	Sc_chr04	283190	283342	152	0.375
841	Sc_chr04	283342	283560	218	0.3256880733944954
842	Sc_chr04	283560	283652	92	0.4673913043478261
843	Sc_chr04	283652	283709	57	0.3508771929824562
844	Sc_chr04	283709	284114	405	0.362962962962963
845	Sc_chr04	284114	284354	240	0.39166666666666666
846	Sc_chr04	284354	284507	153	0.3464052287581699
847	Sc_chr04	284507	284512	5	0.4
848	Sc_chr04	284512	284873	361	0.3656509695290859
849	Sc_chr04	284873	285023	150	0.35333333333333333
850	Sc_chr04	285023	285088	65	0.32307692307692304
851	Sc_chr04	285088	285092	4	0.5
852	Sc_chr04	285092	285422	330	0.3484848484848485
853	Sc_chr04	285422	285521	99	0.4444444444444444
854	Sc_chr04	285521	285697	176	0.36363636363636365
855	Sc_chr04	285697	285766	69	0.43478260869565216
856	Sc_chr04	285766	285885	119	0.42016806722689076
857	Sc_chr04	285885	286214	329	0.41641337386018235
858	Sc_chr04	286214	286278	64	0.34375
859	Sc_chr04	286278	286350	72	0.4027777777777778
860	Sc_chr04	286350	286355	5	0.4
861	Sc_chr04	286355	286767	412	0.43446601941747576
862	Sc_chr04	286767	286950	183	0.39344262295081966
863	Sc_chr04	286950	287097	147	0.4217687074829932
864	Sc_chr04	287097	287154	57	0.5438596491228069
865	Sc_chr04	287154	287989	835	0.4479041916167665
866	Sc_chr04	287989	288011	22	0.2727272727272727
867	Sc_chr04	288011	288818	807	0.4213135068153655
868	Sc_chr04	288818	289127	309	0.4271844660194175
869	Sc_chr04	289127	289374	247	0.4089068825910931
870	Sc_chr04	289374	289431	57	0.368421052631579
871	Sc_chr04	289431	289684	253	0.32015810276679846
872	Sc_chr04	289684	289889	205	0.35609756097560974
873	Sc_chr04	289889	289935	46	0.34782608695652173
874	Sc_chr04	289935	290509	574	0.40069686411149824
875	Sc_chr04	290509	291247	738	0.3902439024390244
876	Sc_chr04	291247	292138	891	0.39057239057239057
877	Sc_chr04	292138	292217	79	0.379746835443038
878	Sc_chr04	292217	292346	129	0.32558139534883723
879	Sc_chr04	292346	292484	138	0.2898550724637681
880	Sc_chr04	292484	292533	49	0.46938775510204084
881	Sc_chr04	292533	292900	367	0.35967302452316074
882	Sc_chr04	292900	292991	91	0.37362637362637363
883	Sc_chr04	292991	293086	95	0.3789473684210526
884	Sc_chr04	293086	293139	53	0.37735849056603776
885	Sc_chr04	293139	293493	354	0.3587570621468927
886	Sc_chr04	293493	293664	171	0.39766081871345027
887	Sc_chr04	293664	293813	149	0.3959731543624161
888	Sc_chr04	293813	294650	837	0.36200716845878134
889	Sc_chr04	294650	295133	483	0.3498964803312629
890	Sc_chr04	295133	295785	652	0.4095092024539877
891	Sc_chr04	295785	296608	823	0.3997569866342649
892	Sc_chr04	296608	296971	363	0.371900826446281
893	Sc_chr04	296971	297067	96	0.32291666666666663
894	Sc_chr04	297067	297113	46	0.43478260869565216
895	Sc_chr04	297113	297386	273	0.31135531135531136
896	Sc_chr04	297386	297459	73	0.32876712328767127
897	Sc_chr04	297459	297526	67	0.3283582089552239
898	Sc_chr04	297526	297801	275	0.34545454545454546
899	Sc_chr04	297801	297921	120	0.39166666666666666
900	Sc_chr04	297921	299845	1924	0.3622661122661123
901	Sc_chr04	299845	300287	442	0.3981900452488688
902	Sc_chr04	300287	300867	580	0.45172413793103444
903	Sc_chr04	300867	300875	8	0.5
904	Sc_chr04	300875	301302	427	0.45433255269320844
905	Sc_chr04	301302	301693	391	0.43478260869565216
906	Sc_chr04	301693	301742	49	0.42857142857142855
907	Sc_chr04	301742	301966	224	0.45535714285714285
908	Sc_chr04	301966	302009	43	0.6511627906976745
909	Sc_chr04	302009	302234	225	0.4622222222222222
910	Sc_chr04	302234	302579	345	0.32753623188405795
911	Sc_chr04	302579	302720	141	0.3687943262411348
912	Sc_chr04	302720	302800	80	0.3625
913	Sc_chr04	302800	302984	184	0.4456521739130435
914	Sc_chr04	302984	303272	288	0.45486111111111116
915	Sc_chr04	303272	303676	404	0.44554455445544555
916	Sc_chr04	303676	303680	4	0.5
917	Sc_chr04	303680	303738	58	0.5172413793103449
918	Sc_chr04	303738	303966	228	0.3859649122807018
919	Sc_chr04	303966	304157	191	0.4397905759162304
920	Sc_chr04	304157	304508	351	0.452991452991453
921	Sc_chr04	304508	306498	1990	0.3798994974874372
922	Sc_chr04	306498	306550	52	0.44230769230769235
923	Sc_chr04	306550	307003	453	0.31125827814569534
924	Sc_chr04	307003	307617	614	0.3925081433224756
925	Sc_chr04	307617	308090	473	0.4143763213530655
926	Sc_chr04	308090	308328	238	0.29831932773109243
927	Sc_chr04	308328	308768	440	0.3477272727272727
928	Sc_chr04	308768	308941	173	0.4046242774566474
929	Sc_chr04	308941	309308	367	0.44141689373297005
930	Sc_chr04	309308	309387	79	0.379746835443038
931	Sc_chr04	309387	310231	844	0.3566350710900474
932	Sc_chr04	310231	310433	202	0.29702970297029707
933	Sc_chr04	310433	310634	201	0.37810945273631835
934	Sc_chr04	310634	310639	5	0.4
935	Sc_chr04	310639	310851	212	0.4245283018867924
936	Sc_chr04	310851	310858	7	0.42857142857142855
937	Sc_chr04	310858	311197	339	0.3893805309734513
938	Sc_chr04	311197	312175	978	0.4049079754601227
939	Sc_chr04	312175	313204	1029	0.39455782312925175
940	Sc_chr04	313204	313339	135	0.3703703703703704
941	Sc_chr04	313339	313501	162	0.4753086419753087
942	Sc_chr04	313501	313561	60	0.41666666666666663
943	Sc_chr04	313561	314483	922	0.3438177874186551
944	Sc_chr04	314483	314929	446	0.3721973094170404
945	Sc_chr04	314929	314957	28	0.6428571428571429
946	Sc_chr04	314957	316966	2009	0.41513190642110503
947	Sc_chr04	316966	317780	814	0.36486486486486486
948	Sc_chr04	317780	318064	284	0.32394366197183094
949	Sc_chr04	318064	318356	292	0.3561643835616438
950	Sc_chr04	318356	318677	321	0.3956386292834891
951	Sc_chr04	318677	318919	242	0.3347107438016529
952	Sc_chr04	318919	318949	30	0.33333333333333337
953	Sc_chr04	318949	319168	219	0.33789954337899547
954	Sc_chr04	319168	319214	46	0.43478260869565216
955	Sc_chr04	319214	319819	605	0.36198347107438017
956	Sc_chr04	319819	319933	114	0.32456140350877194
957	Sc_chr04	319933	319957	24	0.33333333333333337
958	Sc_chr04	319957	320161	204	0.338235294117647
959	Sc_chr04	320161	320791	630	0.373015873015873
960	Sc_chr04	320791	320876	85	0.4
961	Sc_chr04	320876	321530	654	0.3868501529051988
962	Sc_chr04	321530	321976	446	0.38565022421524664
963	Sc_chr04	321976	322405	429	0.36596736596736595
964	Sc_chr04	322405	322412	7	0.28571428571428575
965	Sc_chr04	322412	323108	696	0.34339080459770116
966	Sc_chr04	323108	323336	228	0.3640350877192982
967	Sc_chr04	323336	324537	1201	0.3338884263114072
968	Sc_chr04	324537	324696	159	0.31446540880503143
969	Sc_chr04	324696	324863	167	0.34131736526946105
970	Sc_chr04	324863	324870	7	0.28571428571428575
971	Sc_chr04	324870	325138	268	0.3507462686567164
972	Sc_chr04	325138	325377	239	0.3807531380753138
973	Sc_chr04	325377	325746	369	0.3252032520325204
974	Sc_chr04	325746	326100	354	0.4096045197740113
975	Sc_chr04	326100	326119	19	0.368421052631579
976	Sc_chr04	326119	326340	221	0.3755656108597285
977	Sc_chr04	326340	326381	41	0.2682926829268293
978	Sc_chr04	326381	326392	11	0.36363636363636365
979	Sc_chr04	326392	326445	53	0.3962264150943396
980	Sc_chr04	326445	326481	36	0.33333333333333337
981	Sc_chr04	326481	326592	111	0.36936936936936937
982	Sc_chr04	326592	327383	791	0.3489254108723135
983	Sc_chr04	327383	327397	14	0.42857142857142855
984	Sc_chr04	327397	327442	45	0.26666666666666666
985	Sc_chr04	327442	328941	1499	0.3322214809873249
986	Sc_chr04	328941	329389	448	0.390625
987	Sc_chr04	329389	330294	905	0.34033149171270716
988	Sc_chr04	330294	331509	1215	0.4534979423868312
989	Sc_chr04	331509	332070	561	0.3547237076648841
990	Sc_chr04	332070	332175	105	0.3142857142857143
991	Sc_chr04	332175	332334	159	0.339622641509434
992	Sc_chr04	332334	333240	906	0.2924944812362031
993	Sc_chr04	333240	333401	161	0.39751552795031053
994	Sc_chr04	333401	334366	965	0.3492227979274612
995	Sc_chr04	334366	334609	243	0.4197530864197531
996	Sc_chr04	334609	334770	161	0.40372670807453415
997	Sc_chr04	334770	334823	53	0.3962264150943396
998	Sc_chr04	334823	334956	133	0.43609022556390975
999	Sc_chr04	334956	335070	114	0.456140350877193
1000	Sc_chr04	335070	335290	220	0.45909090909090905
1001	Sc_chr04	335290	335316	26	0.3846153846153846
1002	Sc_chr04	335316	335330	14	0.7142857142857143
1003	Sc_chr04	335330	335613	283	0.4134275618374559
1004	Sc_chr04	335613	336041	428	0.4182242990654206
1005	Sc_chr04	336041	336111	70	0.34285714285714286
1006	Sc_chr04	336111	336301	190	0.29473684210526313
1007	Sc_chr04	336301	336430	129	0.3953488372093023
1008	Sc_chr04	336430	336625	195	0.33333333333333337
1009	Sc_chr04	336625	336670	45	0.37777777777777777
1010	Sc_chr04	336670	336718	48	0.35416666666666663
1011	Sc_chr04	336718	337219	501	0.3832335329341317
1012	Sc_chr04	337219	337650	431	0.33642691415313225
1013	Sc_chr04	337650	337893	243	0.3950617283950617
1014	Sc_chr04	337893	337947	54	0.4444444444444444
1015	Sc_chr04	337947	337999	52	0.4615384615384615
1016	Sc_chr04	337999	338721	722	0.31024930747922436
1017	Sc_chr04	338721	338910	189	0.41798941798941797
1018	Sc_chr04	338910	338928	18	0.4444444444444444
1019	Sc_chr04	338928	339083	155	0.36774193548387096
1020	Sc_chr04	339083	339150	67	0.3283582089552239
1021	Sc_chr04	339150	339239	89	0.3370786516853933
1022	Sc_chr04	339239	339273	34	0.32352941176470584
1023	Sc_chr04	339273	339290	17	0.23529411764705885
1024	Sc_chr04	339290	339428	138	0.3405797101449275
1025	Sc_chr04	339428	339470	42	0.2619047619047619
1026	Sc_chr04	339470	339595	125	0.312
1027	Sc_chr04	339595	339778	183	0.39344262295081966
1028	Sc_chr04	339778	340111	333	0.3753753753753754
1029	Sc_chr04	340111	340123	12	0.25
1030	Sc_chr04	340123	340188	65	0.4153846153846154
1031	Sc_chr04	340188	341371	1183	0.34742180896027053
1032	Sc_chr04	341371	341812	441	0.37414965986394555
1033	Sc_chr04	341812	342142	330	0.3515151515151515
1034	Sc_chr04	342142	342360	218	0.38990825688073394
1035	Sc_chr04	342360	343072	712	0.4297752808988764
1036	Sc_chr04	343072	343280	208	0.3990384615384615
1037	Sc_chr04	343280	343334	54	0.35185185185185186
1038	Sc_chr04	343334	344039	705	0.38156028368794326
1039	Sc_chr04	344039	344788	749	0.36849132176234983
1040	Sc_chr04	344788	345736	948	0.39662447257383965
1041	Sc_chr04	345736	345773	37	0.4324324324324324
1042	Sc_chr04	345773	346039	266	0.4210526315789474
1043	Sc_chr04	346039	346425	386	0.4015544041450777
1044	Sc_chr04	346425	346549	124	0.3387096774193548
1045	Sc_chr04	346549	346782	233	0.3862660944206009
1046	Sc_chr04	346782	346801	19	0.368421052631579
1047	Sc_chr04	346801	346966	165	0.3696969696969697
1048	Sc_chr04	346966	347239	273	0.3223443223443223
1049	Sc_chr04	347239	347296	57	0.368421052631579
1050	Sc_chr04	347296	347793	497	0.3480885311871227
1051	Sc_chr04	347793	349617	1824	0.33826754385964913
1052	Sc_chr04	349617	349787	170	0.33529411764705885
1053	Sc_chr04	349787	349821	34	0.2647058823529412
1054	Sc_chr04	349821	349884	63	0.28571428571428575
1055	Sc_chr04	349884	350388	504	0.3511904761904762
1056	Sc_chr04	350388	350460	72	0.36111111111111116
1057	Sc_chr04	350460	350872	412	0.3713592233009709
1058	Sc_chr04	350872	351074	202	0.4059405940594059
1059	Sc_chr04	351074	351364	290	0.32758620689655177
1060	Sc_chr04	351364	351394	30	0.33333333333333337
1061	Sc_chr04	351394	351805	411	0.3795620437956205
1062	Sc_chr04	351805	351917	112	0.4017857142857143
1063	Sc_chr04	351917	351984	67	0.40298507462686567
1064	Sc_chr04	351984	352213	229	0.47161572052401746
1065	Sc_chr04	352213	352324	111	0.40540540540540543
1066	Sc_chr04	352324	352387	63	0.5079365079365079
1067	Sc_chr04	352387	352479	92	0.358695652173913
1068	Sc_chr04	352479	352515	36	0.4722222222222222
1069	Sc_chr04	352515	352556	41	0.3902439024390244
1070	Sc_chr04	352556	352943	387	0.3462532299741602
1071	Sc_chr04	352943	353155	212	0.38679245283018865
1072	Sc_chr04	353155	353393	238	0.4453781512605042
1073	Sc_chr04	353393	353516	123	0.4390243902439025
1074	Sc_chr04	353516	353626	110	0.45454545454545453
1075	Sc_chr04	353626	353868	242	0.42561983471074377
1076	Sc_chr04	353868	354049	181	0.3812154696132597
1077	Sc_chr04	354049	354140	91	0.43956043956043955
1078	Sc_chr04	354140	354351	211	0.3696682464454976
1079	Sc_chr04	354351	354784	433	0.3279445727482679
1080	Sc_chr04	354784	355341	557	0.34111310592459604
1081	Sc_chr04	355341	355483	142	0.2535211267605634
1082	Sc_chr04	355483	355890	407	0.343980343980344
1083	Sc_chr04	355890	355988	98	0.5
1084	Sc_chr04	355988	357467	1479	0.3935091277890466
1085	Sc_chr04	357467	357547	80	0.5
1086	Sc_chr04	357547	358109	562	0.42170818505338076
1087	Sc_chr04	358109	358296	187	0.36363636363636365
1088	Sc_chr04	358296	359149	853	0.3962485345838218
1089	Sc_chr04	359149	359377	228	0.3289473684210526
1090	Sc_chr04	359377	359943	566	0.34452296819787986
1091	Sc_chr04	359943	360131	188	0.44148936170212766
1092	Sc_chr04	360131	360226	95	0.45263157894736844
1093	Sc_chr04	360226	360374	148	0.40540540540540543
1094	Sc_chr04	360374	360450	76	0.4210526315789474
1095	Sc_chr04	360450	360460	10	0.3
1096	Sc_chr04	360460	360540	80	0.4
1097	Sc_chr04	360540	361024	484	0.40082644628099173
1098	Sc_chr04	361024	361897	873	0.3619702176403207
1099	Sc_chr04	361897	361960	63	0.28571428571428575
1100	Sc_chr04	361960	362407	447	0.407158836689038
1101	Sc_chr04	362407	362538	131	0.3206106870229008
1102	Sc_chr04	362538	362874	336	0.3779761904761905
1103	Sc_chr04	362874	363034	160	0.35625
1104	Sc_chr04	363034	363200	166	0.4216867469879518
1105	Sc_chr04	363200	363741	541	0.421441774491682
1106	Sc_chr04	363741	364443	702	0.40028490028490027
1107	Sc_chr04	364443	364645	202	0.36633663366336633
1108	Sc_chr04	364645	364651	6	0.33333333333333337
1109	Sc_chr04	364651	365225	574	0.33275261324041816
1110	Sc_chr04	365225	365612	387	0.4263565891472868
1111	Sc_chr04	365612	366398	786	0.3880407124681934
1112	Sc_chr04	366398	366964	566	0.4275618374558304
1113	Sc_chr04	366964	367002	38	0.39473684210526316
1114	Sc_chr04	367002	367169	167	0.4311377245508982
1115	Sc_chr04	367169	367256	87	0.4367816091954023
1116	Sc_chr04	367256	367530	274	0.4489051094890511
1117	Sc_chr04	367530	367576	46	0.5
1118	Sc_chr04	367576	367700	124	0.46774193548387094
1119	Sc_chr04	367700	367753	53	0.4339622641509434
1120	Sc_chr04	367753	368057	304	0.4539473684210526
1121	Sc_chr04	368057	368766	709	0.4090267983074753
1122	Sc_chr04	368766	370022	1256	0.4339171974522293
1123	Sc_chr04	370022	370173	151	0.41721854304635764
1124	Sc_chr04	370173	370246	73	0.4383561643835616
1125	Sc_chr04	370246	370292	46	0.45652173913043476
1126	Sc_chr04	370292	370604	312	0.4903846153846154
1127	Sc_chr04	370604	371077	473	0.3171247357293869
1128	Sc_chr04	371077	371649	572	0.41608391608391604
1129	Sc_chr04	371649	371713	64	0.46875
1130	Sc_chr04	371713	371718	5	0.4
1131	Sc_chr04	371718	371759	41	0.4878048780487805
1132	Sc_chr04	371759	371781	22	0.3181818181818182
1133	Sc_chr04	371781	372510	729	0.3827160493827161
1134	Sc_chr04	372510	372696	186	0.27956989247311825
1135	Sc_chr04	372696	373283	587	0.40545144804088584
1136	Sc_chr04	373283	373737	454	0.36784140969163
1137	Sc_chr04	373737	374365	628	0.35350318471337583
1138	Sc_chr04	374365	374595	230	0.3565217391304348
1139	Sc_chr04	374595	374652	57	0.3859649122807018
1140	Sc_chr04	374652	375283	631	0.38510301109350237
1141	Sc_chr04	375283	375472	189	0.36507936507936506
1142	Sc_chr04	375472	376075	603	0.3399668325041459
1143	Sc_chr04	376075	376329	254	0.3779527559055118
1144	Sc_chr04	376329	376950	621	0.36553945249597425
1145	Sc_chr04	376950	377571	621	0.3816425120772947
1146	Sc_chr04	377571	377593	22	0.45454545454545453
1147	Sc_chr04	377593	377618	25	0.4
1148	Sc_chr04	377618	377632	14	0.5714285714285715
1149	Sc_chr04	377632	377709	77	0.35064935064935066
1150	Sc_chr04	377709	377913	204	0.3627450980392157
1151	Sc_chr04	377913	378180	267	0.4082397003745319
1152	Sc_chr04	378180	378252	72	0.5138888888888888
1153	Sc_chr04	378252	378352	100	0.38
1154	Sc_chr04	378352	378963	611	0.38134206219312605
1155	Sc_chr04	378963	379139	176	0.3522727272727273
1156	Sc_chr04	379139	379412	273	0.391941391941392
1157	Sc_chr04	379412	379574	162	0.3827160493827161
1158	Sc_chr04	379574	380300	726	0.38980716253443526
1159	Sc_chr04	380300	380312	12	0.5833333333333334
1160	Sc_chr04	380312	380634	322	0.3695652173913044
1161	Sc_chr04	380634	382825	2191	0.39205842081241443
1162	Sc_chr04	382825	382891	66	0.5
1163	Sc_chr04	382891	383033	142	0.40845070422535207
1164	Sc_chr04	383033	383141	108	0.39814814814814814
1165	Sc_chr04	383141	383204	63	0.4603174603174603
1166	Sc_chr04	383204	383321	117	0.4102564102564103
1167	Sc_chr04	383321	383357	36	0.4722222222222222
1168	Sc_chr04	383357	383483	126	0.4444444444444444
1169	Sc_chr04	383483	383555	72	0.41666666666666663
1170	Sc_chr04	383555	383591	36	0.5
1171	Sc_chr04	383591	384035	444	0.42792792792792794
1172	Sc_chr04	384035	384107	72	0.4722222222222222
1173	Sc_chr04	384107	384179	72	0.38888888888888884
1174	Sc_chr04	384179	384305	126	0.4365079365079365
1175	Sc_chr04	384305	384341	36	0.4444444444444444
1176	Sc_chr04	384341	384413	72	0.4722222222222222
1177	Sc_chr04	384413	384467	54	0.38888888888888884
1178	Sc_chr04	384467	384503	36	0.4444444444444444
1179	Sc_chr04	384503	384611	108	0.42592592592592593
1180	Sc_chr04	384611	385376	765	0.4091503267973856
1181	Sc_chr04	385376	385649	273	0.37362637362637363
1182	Sc_chr04	385649	385864	215	0.3674418604651163
1183	Sc_chr04	385864	386014	150	0.36666666666666664
1184	Sc_chr04	386014	386019	5	0.4
1185	Sc_chr04	386019	386829	810	0.3765432098765432
1186	Sc_chr04	386829	386906	77	0.3246753246753247
1187	Sc_chr04	386906	386955	49	0.46938775510204084
1188	Sc_chr04	386955	386979	24	0.5
1189	Sc_chr04	386979	387198	219	0.3972602739726028
1190	Sc_chr04	387198	387619	421	0.3586698337292162
1191	Sc_chr04	387619	387625	6	0.33333333333333337
1192	Sc_chr04	387625	387640	15	0.6
1193	Sc_chr04	387640	387838	198	0.3838383838383838
1194	Sc_chr04	387838	387891	53	0.37735849056603776
1195	Sc_chr04	387891	388025	134	0.44029850746268656
1196	Sc_chr04	388025	388123	98	0.3877551020408163
1197	Sc_chr04	388123	388486	363	0.3884297520661157
1198	Sc_chr04	388486	388618	132	0.38636363636363635
1199	Sc_chr04	388618	389257	639	0.3380281690140845
1200	Sc_chr04	389257	389530	273	0.3699633699633699
1201	Sc_chr04	389530	389564	34	0.38235294117647056
1202	Sc_chr04	389564	389653	89	0.4606741573033708
1203	Sc_chr04	389653	391042	1389	0.34557235421166305
1204	Sc_chr04	391042	391113	71	0.26760563380281693
1205	Sc_chr04	391113	391557	444	0.36936936936936937
1206	Sc_chr04	391557	391592	35	0.34285714285714286
1207	Sc_chr04	391592	391786	194	0.3505154639175258
1208	Sc_chr04	391786	392094	308	0.45454545454545453
1209	Sc_chr04	392094	393371	1277	0.413469068128426
1210	Sc_chr04	393371	394243	872	0.411697247706422
1211	Sc_chr04	394243	394252	9	0.4444444444444444
1212	Sc_chr04	394252	394395	143	0.4405594405594405
1213	Sc_chr04	394395	395428	1033	0.3823814133591481
1214	Sc_chr04	395428	396037	609	0.3842364532019705
1215	Sc_chr04	396037	396168	131	0.3969465648854962
1216	Sc_chr04	396168	396568	400	0.375
1217	Sc_chr04	396568	397222	654	0.38990825688073394
1218	Sc_chr04	397222	397453	231	0.3203463203463203
1219	Sc_chr04	397453	397684	231	0.3939393939393939
1220	Sc_chr04	397684	397980	296	0.32094594594594594
1221	Sc_chr04	397980	398202	222	0.38288288288288286
1222	Sc_chr04	398202	398347	145	0.3655172413793103
1223	Sc_chr04	398347	399489	1142	0.37740805604203154
1224	Sc_chr04	399489	400041	552	0.42391304347826086
1225	Sc_chr04	400041	400494	453	0.3973509933774835
1226	Sc_chr04	400494	400652	158	0.41139240506329117
1227	Sc_chr04	400652	400904	252	0.24206349206349206
1228	Sc_chr04	400904	401049	145	0.3310344827586207
1229	Sc_chr04	401049	401120	71	0.39436619718309857
1230	Sc_chr04	401120	401730	610	0.38032786885245906
1231	Sc_chr04	401730	401912	182	0.37362637362637363
1232	Sc_chr04	401912	401939	27	0.4444444444444444
1233	Sc_chr04	401939	402143	204	0.35294117647058826
1234	Sc_chr04	402143	402343	200	0.335
1235	Sc_chr04	402343	402365	22	0.36363636363636365
1236	Sc_chr04	402365	403108	743	0.37685060565275913
1237	Sc_chr04	403108	403178	70	0.3285714285714285
1238	Sc_chr04	403178	403302	124	0.3629032258064516
1239	Sc_chr04	403302	403444	142	0.32394366197183094
1240	Sc_chr04	403444	404132	688	0.31540697674418605
1241	Sc_chr04	404132	404166	34	0.4411764705882353
1242	Sc_chr04	404166	404352	186	0.3870967741935484
1243	Sc_chr04	404352	405744	1392	0.35704022988505746
1244	Sc_chr04	405744	406412	668	0.3922155688622755
1245	Sc_chr04	406412	406979	567	0.42857142857142855
1246	Sc_chr04	406979	407013	34	0.35294117647058826
1247	Sc_chr04	407013	407048	35	0.34285714285714286
1248	Sc_chr04	407048	408755	1707	0.38488576449912126
1249	Sc_chr04	408755	409133	378	0.38888888888888884
1250	Sc_chr04	409133	409540	407	0.36609336609336607
1251	Sc_chr04	409540	410193	653	0.3966309341500766
1252	Sc_chr04	410193	411291	1098	0.436247723132969
1253	Sc_chr04	411291	411400	109	0.45871559633027525
1254	Sc_chr04	411400	411945	545	0.4458715596330275
1255	Sc_chr04	411945	412051	106	0.44339622641509435
1256	Sc_chr04	412051	412648	597	0.44388609715242877
1257	Sc_chr04	412648	412729	81	0.3950617283950617
1258	Sc_chr04	412729	412982	253	0.4505928853754941
1259	Sc_chr04	412982	414441	1459	0.34544208361891704
1260	Sc_chr04	414441	414691	250	0.37200000000000005
1261	Sc_chr04	414691	414822	131	0.33587786259541985
1262	Sc_chr04	414822	414839	17	0.411764705882353
1263	Sc_chr04	414839	415251	412	0.30097087378640774
1264	Sc_chr04	415251	415786	535	0.3850467289719626
1265	Sc_chr04	415786	415840	54	0.42592592592592593
1266	Sc_chr04	415840	415939	99	0.3838383838383838
1267	Sc_chr04	415939	416434	495	0.3818181818181818
1268	Sc_chr04	416434	416832	398	0.3592964824120603
1269	Sc_chr04	416832	417086	254	0.38976377952755903
1270	Sc_chr04	417086	417216	130	0.4230769230769231
1271	Sc_chr04	417216	417694	478	0.3389121338912134
1272	Sc_chr04	417694	417895	201	0.4079601990049751
1273	Sc_chr04	417895	418093	198	0.4797979797979798
1274	Sc_chr04	418093	418151	58	0.41379310344827586
1275	Sc_chr04	418151	418249	98	0.41836734693877553
1276	Sc_chr04	418249	418425	176	0.38636363636363635
1277	Sc_chr04	418425	419044	619	0.395799676898223
1278	Sc_chr04	419044	419794	750	0.38799999999999996
1279	Sc_chr04	419794	419892	98	0.3469387755102041
1280	Sc_chr04	419892	420249	357	0.4565826330532213
1281	Sc_chr04	420249	420904	655	0.41068702290076337
1282	Sc_chr04	420904	421145	241	0.3360995850622407
1283	Sc_chr04	421145	421480	335	0.41791044776119407
1284	Sc_chr04	421480	423071	1591	0.35763670647391577
1285	Sc_chr04	423071	423170	99	0.4444444444444444
1286	Sc_chr04	423170	423268	98	0.40816326530612246
1287	Sc_chr04	423268	423745	477	0.38784067085953877
1288	Sc_chr04	423745	424280	535	0.3626168224299065
1289	Sc_chr04	424280	424321	41	0.3170731707317073
1290	Sc_chr04	424321	424503	182	0.3626373626373626
1291	Sc_chr04	424503	424547	44	0.5
1292	Sc_chr04	424547	424607	60	0.4666666666666666
1293	Sc_chr04	424607	424985	378	0.373015873015873
1294	Sc_chr04	424985	425519	534	0.38576779026217234
1295	Sc_chr04	425519	425564	45	0.4
1296	Sc_chr04	425564	425999	435	0.367816091954023
1297	Sc_chr04	425999	426217	218	0.3348623853211009
1298	Sc_chr04	426217	427331	1114	0.32854578096947934
1299	Sc_chr04	427331	427805	474	0.5379746835443038
1300	Sc_chr04	427805	428104	299	0.42474916387959866
1301	Sc_chr04	428104	429393	1289	0.3630721489526765
1302	Sc_chr04	429393	429414	21	0.4761904761904762
1303	Sc_chr04	429414	429420	6	0.33333333333333337
1304	Sc_chr04	429420	429654	234	0.4358974358974359
1305	Sc_chr04	429654	430313	659	0.42943854324734443
1306	Sc_chr04	430313	430611	298	0.43288590604026844
1307	Sc_chr04	430611	431028	417	0.3764988009592326
1308	Sc_chr04	431028	431436	408	0.44852941176470584
1309	Sc_chr04	431436	431750	314	0.3885350318471337
1310	Sc_chr04	431750	431985	235	0.38723404255319144
1311	Sc_chr04	431985	432097	112	0.45535714285714285
1312	Sc_chr04	432097	432227	130	0.5076923076923077
1313	Sc_chr04	432227	432489	262	0.3206106870229008
1314	Sc_chr04	432489	433583	1094	0.3747714808043876
1315	Sc_chr04	433583	433673	90	0.4666666666666666
1316	Sc_chr04	433673	433718	45	0.4
1317	Sc_chr04	433718	434288	570	0.3631578947368421
1318	Sc_chr04	434288	434644	356	0.3258426966292135
1319	Sc_chr04	434644	435405	761	0.3088042049934297
1320	Sc_chr04	435405	435694	289	0.3252595155709343
1321	Sc_chr04	435694	435936	242	0.4214876033057851
1322	Sc_chr04	435936	436634	698	0.33381088825214905
1323	Sc_chr04	436634	436986	352	0.3352272727272727
1324	Sc_chr04	436986	437310	324	0.3703703703703704
1325	Sc_chr04	437310	437466	156	0.3141025641025641
1326	Sc_chr04	437466	438092	626	0.3322683706070288
1327	Sc_chr04	438092	438391	299	0.35785953177257523
1328	Sc_chr04	438391	438538	147	0.39455782312925175
1329	Sc_chr04	438538	439078	540	0.42407407407407405
1330	Sc_chr04	439078	439105	27	0.2962962962962963
1331	Sc_chr04	439105	440406	1301	0.34819369715603377
1332	Sc_chr04	440406	440503	97	0.4536082474226804
1333	Sc_chr04	440503	440628	125	0.376
1334	Sc_chr04	440628	440758	130	0.3769230769230769
1335	Sc_chr04	440758	441752	994	0.3732394366197183
1336	Sc_chr04	441752	442338	586	0.3822525597269625
1337	Sc_chr04	442338	443062	724	0.3425414364640884
1338	Sc_chr04	443062	443825	763	0.36041939711664484
1339	Sc_chr04	443825	444225	400	0.3375
1340	Sc_chr04	444225	444788	563	0.33747779751332146
1341	Sc_chr04	444788	445417	629	0.4006359300476947
1342	Sc_chr04	445417	445534	117	0.4188034188034188
1343	Sc_chr04	445534	445724	190	0.37368421052631584
1344	Sc_chr04	445724	445813	89	0.3370786516853933
1345	Sc_chr04	445813	446439	626	0.37539936102236426
1346	Sc_chr04	446439	446548	109	0.29357798165137616
1347	Sc_chr04	446548	447027	479	0.35490605427974947
1348	Sc_chr04	447027	447208	181	0.3259668508287293
1349	Sc_chr04	447208	447307	99	0.4343434343434343
1350	Sc_chr04	447307	447400	93	0.3978494623655914
1351	Sc_chr04	447400	447421	21	0.42857142857142855
1352	Sc_chr04	447421	447532	111	0.42342342342342343
1353	Sc_chr04	447532	448001	469	0.34541577825159914
1354	Sc_chr04	448001	448141	140	0.4142857142857143
1355	Sc_chr04	448141	448173	32	0.4375
1356	Sc_chr04	448173	448592	419	0.41050119331742246
1357	Sc_chr04	448592	449004	412	0.31796116504854366
1358	Sc_chr04	449004	449086	82	0.3902439024390244
1359	Sc_chr04	449086	449135	49	0.3877551020408163
1360	Sc_chr04	449135	449236	101	0.36633663366336633
1361	Sc_chr04	449236	449283	47	0.4042553191489362
1362	Sc_chr04	449283	449933	650	0.2784615384615385
1363	Sc_chr04	449933	450143	210	0.3380952380952381
1364	Sc_chr04	450143	450425	282	0.38652482269503546
1365	Sc_chr04	450425	450914	489	0.4171779141104295
1366	Sc_chr04	450914	451190	276	0.39855072463768115
1367	Sc_chr04	451190	451256	66	0.5
1368	Sc_chr04	451256	451408	152	0.43421052631578944
1369	Sc_chr04	451408	451868	460	0.3760869565217391
1370	Sc_chr04	451868	452112	244	0.38114754098360654
1371	Sc_chr04	452112	452316	204	0.38235294117647056
1372	Sc_chr04	452316	452393	77	0.5194805194805194
1373	Sc_chr04	452393	452651	258	0.32945736434108525
1374	Sc_chr04	452651	452708	57	0.4385964912280702
1375	Sc_chr04	452708	452989	281	0.3487544483985765
1376	Sc_chr04	452989	453504	515	0.4058252427184466
1377	Sc_chr04	453504	454138	634	0.334384858044164
1378	Sc_chr04	454138	454205	67	0.3283582089552239
1379	Sc_chr04	454205	455840	1635	0.3914373088685015
1380	Sc_chr04	455840	456855	1015	0.3645320197044335
1381	Sc_chr04	456855	457878	1023	0.37145650048875856
1382	Sc_chr04	457878	459062	1184	0.3682432432432432
1383	Sc_chr04	459062	459224	162	0.33333333333333337
1384	Sc_chr04	459224	459303	79	0.3924050632911393
1385	Sc_chr04	459303	459317	14	0.35714285714285715
1386	Sc_chr04	459317	460542	1225	0.3436734693877551
1387	Sc_chr04	460542	460827	285	0.431578947368421
1388	Sc_chr04	460827	460940	113	0.4690265486725664
1389	Sc_chr04	460940	461137	197	0.41116751269035534
1390	Sc_chr04	461137	461454	317	0.473186119873817
1391	Sc_chr04	461454	461707	253	0.4110671936758893
1392	Sc_chr04	461707	462591	884	0.41855203619909503
1393	Sc_chr04	462591	463106	515	0.36116504854368936
1394	Sc_chr04	463106	463730	624	0.39583333333333337
1395	Sc_chr04	463730	463763	33	0.45454545454545453
1396	Sc_chr04	463763	463879	116	0.4051724137931034
1397	Sc_chr04	463879	464057	178	0.4438202247191011
1398	Sc_chr04	464057	464087	30	0.43333333333333335
1399	Sc_chr04	464087	464918	831	0.4235860409145608
1400	Sc_chr04	464918	465230	312	0.4455128205128205
1401	Sc_chr04	465230	465350	120	0.425
1402	Sc_chr04	465350	466439	1089	0.418732782369146
1403	Sc_chr04	466439	466548	109	0.4403669724770642
1404	Sc_chr04	466548	467096	548	0.3886861313868613
1405	Sc_chr04	467096	467184	88	0.4318181818181818
1406	Sc_chr04	467184	467204	20	0.4
1407	Sc_chr04	467204	467527	323	0.35294117647058826
1408	Sc_chr04	467527	467800	273	0.4065934065934066
1409	Sc_chr04	467800	467846	46	0.34782608695652173
1410	Sc_chr04	467846	467954	108	0.36111111111111116
1411	Sc_chr04	467954	468337	383	0.402088772845953
1412	Sc_chr04	468337	469064	727	0.3988995873452545
1413	Sc_chr04	469064	469715	651	0.38402457757296465
1414	Sc_chr04	469715	469816	101	0.3465346534653465
1415	Sc_chr04	469816	469883	67	0.3582089552238806
1416	Sc_chr04	469883	470707	824	0.3434466019417476
1417	Sc_chr04	470707	471746	1039	0.3339749759384023
1418	Sc_chr04	471746	472102	356	0.4438202247191011
1419	Sc_chr04	472102	472954	852	0.4647887323943662
1420	Sc_chr04	472954	474091	1137	0.34564643799472294
1421	Sc_chr04	474091	474732	641	0.36349453978159124
1422	Sc_chr04	474732	475036	304	0.28618421052631576
1423	Sc_chr04	475036	475742	706	0.3271954674220963
1424	Sc_chr04	475742	476142	400	0.3325
1425	Sc_chr04	476142	476485	343	0.27696793002915454
1426	Sc_chr04	476485	476901	416	0.3269230769230769
1427	Sc_chr04	476901	477080	179	0.3966480446927374
1428	Sc_chr04	477080	477561	481	0.35343035343035345
1429	Sc_chr04	477561	477806	245	0.3510204081632653
1430	Sc_chr04	477806	478075	269	0.4312267657992565
1431	Sc_chr04	478075	478665	590	0.38813559322033897
1432	Sc_chr04	478665	478914	249	0.4216867469879518
1433	Sc_chr04	478914	479206	292	0.3150684931506849
1434	Sc_chr04	479206	479525	319	0.36363636363636365
1435	Sc_chr04	479525	479672	147	0.30612244897959184
1436	Sc_chr04	479672	479938	266	0.39849624060150374
1437	Sc_chr04	479938	480388	450	0.36
1438	Sc_chr04	480388	480641	253	0.3992094861660079
1439	Sc_chr04	480641	480861	220	0.42727272727272725
1440	Sc_chr04	480861	481069	208	0.3990384615384615
1441	Sc_chr04	481069	482158	1089	0.39026629935720847
1442	Sc_chr04	482158	482460	302	0.32781456953642385
1443	Sc_chr04	482460	482854	394	0.3477157360406091
1444	Sc_chr04	482854	482915	61	0.39344262295081966
1445	Sc_chr04	482915	483632	717	0.3807531380753138
1446	Sc_chr04	483632	483725	93	0.3440860215053763
1447	Sc_chr04	483725	483928	203	0.3990147783251231
1448	Sc_chr04	483928	483989	61	0.4918032786885246
1449	Sc_chr04	483989	484082	93	0.25806451612903225
1450	Sc_chr04	484082	484369	287	0.37282229965156793
1451	Sc_chr04	484369	484494	125	0.41600000000000004
1452	Sc_chr04	484494	484803	309	0.42394822006472493
1453	Sc_chr04	484803	484880	77	0.41558441558441556
1454	Sc_chr04	484880	485641	761	0.4152431011826544
1455	Sc_chr04	485641	485753	112	0.4107142857142857
1456	Sc_chr04	485753	485928	175	0.4057142857142857
1457	Sc_chr04	485928	486003	75	0.44
1458	Sc_chr04	486003	486588	585	0.3401709401709402
1459	Sc_chr04	486588	487469	881	0.3439273552780931
1460	Sc_chr04	487469	488166	697	0.3486370157819226
1461	Sc_chr04	488166	488375	209	0.3875598086124402
1462	Sc_chr04	488375	488571	196	0.37755102040816324
1463	Sc_chr04	488571	488797	226	0.32300884955752207
1464	Sc_chr04	488797	488821	24	0.5833333333333334
1465	Sc_chr04	488821	489429	608	0.3486842105263158
1466	Sc_chr04	489429	489999	570	0.35614035087719303
1467	Sc_chr04	489999	490463	464	0.39224137931034486
1468	Sc_chr04	490463	492059	1596	0.3703007518796993
1469	Sc_chr04	492059	492847	788	0.383248730964467
1470	Sc_chr04	492847	492888	41	0.4878048780487805
1471	Sc_chr04	492888	493208	320	0.384375
1472	Sc_chr04	493208	493507	299	0.4013377926421405
1473	Sc_chr04	493507	493784	277	0.37906137184115524
1474	Sc_chr04	493784	493841	57	0.4736842105263158
1475	Sc_chr04	493841	493912	71	0.352112676056338
1476	Sc_chr04	493912	494479	567	0.3880070546737213
1477	Sc_chr04	494479	494493	14	0.28571428571428575
1478	Sc_chr04	494493	495317	824	0.3774271844660194
1479	Sc_chr04	495317	495467	150	0.2733333333333333
1480	Sc_chr04	495467	495948	481	0.3575883575883576
1481	Sc_chr04	495948	496002	54	0.3703703703703704
1482	Sc_chr04	496002	496888	886	0.3577878103837472
1483	Sc_chr04	496888	497046	158	0.3924050632911393
1484	Sc_chr04	497046	497124	78	0.3846153846153846
1485	Sc_chr04	497124	497232	108	0.42592592592592593
1486	Sc_chr04	497232	497501	269	0.3828996282527881
1487	Sc_chr04	497501	497560	59	0.3220338983050848
1488	Sc_chr04	497560	497759	199	0.35175879396984927
1489	Sc_chr04	497759	497777	18	0.5
1490	Sc_chr04	497777	498076	299	0.3846153846153846
1491	Sc_chr04	498076	498535	459	0.43572984749455335
1492	Sc_chr04	498535	498555	20	0.35
1493	Sc_chr04	498555	498744	189	0.4074074074074074
1494	Sc_chr04	498744	499050	306	0.3758169934640523
1495	Sc_chr04	499050	499630	580	0.36724137931034484
1496	Sc_chr04	499630	499648	18	0.4444444444444444
1497	Sc_chr04	499648	499933	285	0.4140350877192982
1498	Sc_chr04	499933	500063	130	0.4
1499	Sc_chr04	500063	500137	74	0.35135135135135137
1500	Sc_chr04	500137	500317	180	0.39444444444444443
1501	Sc_chr04	500317	500655	338	0.3668639053254438
1502	Sc_chr04	500655	501771	1116	0.3557347670250896
1503	Sc_chr04	501771	502240	469	0.3944562899786781
1504	Sc_chr04	502240	502324	84	0.28571428571428575
1505	Sc_chr04	502324	502776	452	0.37610619469026546
1506	Sc_chr04	502776	502970	194	0.3711340206185567
1507	Sc_chr04	502970	503176	206	0.3543689320388349
1508	Sc_chr04	503176	503186	10	0.4
1509	Sc_chr04	503186	503266	80	0.3
1510	Sc_chr04	503266	504053	787	0.34561626429479037
1511	Sc_chr04	504053	504171	118	0.364406779661017
1512	Sc_chr04	504171	504808	637	0.434850863422292
1513	Sc_chr04	504808	504982	174	0.4367816091954023
1514	Sc_chr04	504982	505867	885	0.3491525423728814
1515	Sc_chr04	505867	507743	1876	0.3678038379530917
1516	Sc_chr04	507743	507893	150	0.2733333333333333
1517	Sc_chr04	507893	508616	723	0.33333333333333337
1518	Sc_chr04	508616	508878	262	0.416030534351145
1519	Sc_chr04	508878	509378	500	0.332
1520	Sc_chr04	509378	509443	65	0.3076923076923077
1521	Sc_chr04	509443	510431	988	0.32793522267206476
1522	Sc_chr04	510431	510530	99	0.26262626262626265
1523	Sc_chr04	510530	510568	38	0.2368421052631579
1524	Sc_chr04	510568	511454	886	0.3713318284424379
1525	Sc_chr04	511454	511757	303	0.4059405940594059
1526	Sc_chr04	511757	511769	12	0.33333333333333337
1527	Sc_chr04	511769	511909	140	0.40714285714285714
1528	Sc_chr04	511909	512124	215	0.40930232558139534
1529	Sc_chr04	512124	512501	377	0.4190981432360743
1530	Sc_chr04	512501	513868	1367	0.30651060716898315
1531	Sc_chr04	513868	514039	171	0.30994152046783624
1532	Sc_chr04	514039	514240	201	0.3034825870646766
1533	Sc_chr04	514240	514247	7	0.42857142857142855
1534	Sc_chr04	514247	514891	644	0.3509316770186335
1535	Sc_chr04	514891	515472	581	0.3356282271944922
1536	Sc_chr04	515472	515684	212	0.28773584905660377
1537	Sc_chr04	515684	515768	84	0.35714285714285715
1538	Sc_chr04	515768	515996	228	0.3859649122807018
1539	Sc_chr04	515996	516012	16	0.5
1540	Sc_chr04	516012	516383	371	0.4123989218328841
1541	Sc_chr04	516383	516519	136	0.3897058823529412
1542	Sc_chr04	516519	516555	36	0.33333333333333337
1543	Sc_chr04	516555	516573	18	0.2777777777777778
1544	Sc_chr04	516573	516639	66	0.3181818181818182
1545	Sc_chr04	516639	517158	519	0.3872832369942196
1546	Sc_chr04	517158	517406	248	0.3790322580645162
1547	Sc_chr04	517406	517721	315	0.3682539682539682
1548	Sc_chr04	517721	517791	70	0.34285714285714286
1549	Sc_chr04	517791	517955	164	0.3719512195121951
1550	Sc_chr04	517955	517998	43	0.4418604651162791
1551	Sc_chr04	517998	518122	124	0.3951612903225806
1552	Sc_chr04	518122	518489	367	0.3433242506811989
1553	Sc_chr04	518489	518926	437	0.34782608695652173
1554	Sc_chr04	518926	519262	336	0.46726190476190477
1555	Sc_chr04	519262	519495	233	0.3133047210300429
1556	Sc_chr04	519495	519779	284	0.352112676056338
1557	Sc_chr04	519779	520656	877	0.314709236031927
1558	Sc_chr04	520656	521006	350	0.3257142857142857
1559	Sc_chr04	521006	521830	824	0.3446601941747573
1560	Sc_chr04	521830	521881	51	0.4901960784313726
1561	Sc_chr04	521881	521899	18	0.5
1562	Sc_chr04	521899	521995	96	0.375
1563	Sc_chr04	521995	522012	17	0.35294117647058826
1564	Sc_chr04	522012	522531	519	0.4315992292870906
1565	Sc_chr04	522531	522642	111	0.3603603603603604
1566	Sc_chr04	522642	523677	1035	0.3613526570048309
1567	Sc_chr04	523677	523968	291	0.3676975945017182
1568	Sc_chr04	523968	525123	1155	0.4164502164502164
1569	Sc_chr04	525123	525643	520	0.3653846153846154
1570	Sc_chr04	525643	525668	25	0.36
1571	Sc_chr04	525668	525946	278	0.40647482014388486
1572	Sc_chr04	525946	526149	203	0.4433497536945813
1573	Sc_chr04	526149	526384	235	0.38723404255319144
1574	Sc_chr04	526384	526539	155	0.3548387096774194
1575	Sc_chr04	526539	526582	43	0.4186046511627907
1576	Sc_chr04	526582	526684	102	0.3627450980392157
1577	Sc_chr04	526684	526879	195	0.37435897435897436
1578	Sc_chr04	526879	526957	78	0.4230769230769231
1579	Sc_chr04	526957	527005	48	0.4375
1580	Sc_chr04	527005	527486	481	0.36174636174636177
1581	Sc_chr04	527486	527797	311	0.4115755627009646
1582	Sc_chr04	527797	527872	75	0.5066666666666666
1583	Sc_chr04	527872	527953	81	0.4074074074074074
1584	Sc_chr04	527953	528204	251	0.398406374501992
1585	Sc_chr04	528204	528471	267	0.3970037453183521
1586	Sc_chr04	528471	528568	97	0.4742268041237114
1587	Sc_chr04	528568	528749	181	0.4696132596685083
1588	Sc_chr04	528749	528827	78	0.3717948717948718
1589	Sc_chr04	528827	528842	15	0.4
1590	Sc_chr04	528842	529349	507	0.4023668639053255
1591	Sc_chr04	529349	529391	42	0.35714285714285715
1592	Sc_chr04	529391	529539	148	0.41891891891891897
1593	Sc_chr04	529539	529946	407	0.4201474201474201
1594	Sc_chr04	529946	530084	138	0.4057971014492754
1595	Sc_chr04	530084	530445	361	0.41551246537396125
1596	Sc_chr04	530445	531371	926	0.3369330453563715
1597	Sc_chr04	531371	531682	311	0.4212218649517685
1598	Sc_chr04	531682	531757	75	0.52
1599	Sc_chr04	531757	531838	81	0.4074074074074074
1600	Sc_chr04	531838	532089	251	0.40637450199203184
1601	Sc_chr04	532089	532356	267	0.3970037453183521
1602	Sc_chr04	532356	532453	97	0.4742268041237114
1603	Sc_chr04	532453	532634	181	0.4696132596685083
1604	Sc_chr04	532634	532712	78	0.3717948717948718
1605	Sc_chr04	532712	532727	15	0.4
1606	Sc_chr04	532727	533234	507	0.4023668639053255
1607	Sc_chr04	533234	533276	42	0.35714285714285715
1608	Sc_chr04	533276	533424	148	0.41891891891891897
1609	Sc_chr04	533424	533831	407	0.4201474201474201
1610	Sc_chr04	533831	533969	138	0.4057971014492754
1611	Sc_chr04	533969	534330	361	0.41551246537396125
1612	Sc_chr04	534330	535256	926	0.3369330453563715
1613	Sc_chr04	535256	535567	311	0.42443729903536975
1614	Sc_chr04	535567	535642	75	0.52
1615	Sc_chr04	535642	535723	81	0.4074074074074074
1616	Sc_chr04	535723	535974	251	0.40637450199203184
1617	Sc_chr04	535974	536241	267	0.39325842696629215
1618	Sc_chr04	536241	536338	97	0.4742268041237114
1619	Sc_chr04	536338	536519	181	0.4696132596685083
1620	Sc_chr04	536519	536597	78	0.3717948717948718
1621	Sc_chr04	536597	536612	15	0.4
1622	Sc_chr04	536612	537119	507	0.4023668639053255
1623	Sc_chr04	537119	537161	42	0.35714285714285715
1624	Sc_chr04	537161	537309	148	0.41891891891891897
1625	Sc_chr04	537309	537716	407	0.4201474201474201
1626	Sc_chr04	537716	537854	138	0.4057971014492754
1627	Sc_chr04	537854	538242	388	0.4020618556701031
1628	Sc_chr04	538242	539214	972	0.3734567901234568
1629	Sc_chr04	539214	539827	613	0.39477977161500816
1630	Sc_chr04	539827	539944	117	0.3846153846153846
1631	Sc_chr04	539944	541706	1762	0.35073779795686716
1632	Sc_chr04	541706	542201	495	0.36363636363636365
1633	Sc_chr04	542201	542450	249	0.40160642570281124
1634	Sc_chr04	542450	542534	84	0.40476190476190477
1635	Sc_chr04	542534	542897	363	0.35537190082644626
1636	Sc_chr04	542897	545865	2968	0.3675876010781671
1637	Sc_chr04	545865	545975	110	0.45454545454545453
1638	Sc_chr04	545975	546432	457	0.437636761487965
1639	Sc_chr04	546432	546656	224	0.36607142857142855
1640	Sc_chr04	546656	546905	249	0.45783132530120485
1641	Sc_chr04	546905	546932	27	0.4074074074074074
1642	Sc_chr04	546932	547657	725	0.4303448275862069
1643	Sc_chr04	547657	547764	107	0.23364485981308414
1644	Sc_chr04	547764	547830	66	0.3181818181818182
1645	Sc_chr04	547830	547895	65	0.32307692307692304
1646	Sc_chr04	547895	548120	225	0.32888888888888884
1647	Sc_chr04	548120	548465	345	0.3594202898550725
1648	Sc_chr04	548465	548881	416	0.3317307692307692
1649	Sc_chr04	548881	549125	244	0.42213114754098363
1650	Sc_chr04	549125	549534	409	0.46210268948655253
1651	Sc_chr04	549534	549589	55	0.32727272727272727
1652	Sc_chr04	549589	550566	977	0.406345957011259
1653	Sc_chr04	550566	550771	205	0.351219512195122
1654	Sc_chr04	550771	550926	155	0.4129032258064516
1655	Sc_chr04	550926	551308	382	0.4607329842931937
1656	Sc_chr04	551308	551570	262	0.41221374045801523
1657	Sc_chr04	551570	551742	172	0.4069767441860465
1658	Sc_chr04	551742	552272	530	0.41698113207547166
1659	Sc_chr04	552272	552355	83	0.49397590361445787
1660	Sc_chr04	552355	552623	268	0.39552238805970147
1661	Sc_chr04	552623	552765	142	0.4859154929577465
1662	Sc_chr04	552765	552891	126	0.4365079365079365
1663	Sc_chr04	552891	553220	329	0.2826747720364742
1664	Sc_chr04	553220	553301	81	0.4074074074074074
1665	Sc_chr04	553301	553427	126	0.35714285714285715
1666	Sc_chr04	553427	553670	243	0.4197530864197531
1667	Sc_chr04	553670	553697	27	0.5185185185185186
1668	Sc_chr04	553697	554741	1044	0.3917624521072797
1669	Sc_chr04	554741	554749	8	0.5
1670	Sc_chr04	554749	555442	693	0.34487734487734484
1671	Sc_chr04	555442	556173	731	0.3857729138166895
1672	Sc_chr04	556173	557389	1216	0.39226973684210525
1673	Sc_chr04	557389	557597	208	0.3653846153846154
1674	Sc_chr04	557597	557828	231	0.3593073593073593
1675	Sc_chr04	557828	558244	416	0.3822115384615385
1676	Sc_chr04	558244	559547	1303	0.36377590176515734
1677	Sc_chr04	559547	559967	420	0.37857142857142856
1678	Sc_chr04	559967	560449	482	0.3858921161825726
1679	Sc_chr04	560449	560727	278	0.36330935251798563
1680	Sc_chr04	560727	560847	120	0.325
1681	Sc_chr04	560847	561827	980	0.3357142857142857
1682	Sc_chr04	561827	561949	122	0.4098360655737705
1683	Sc_chr04	561949	562014	65	0.5538461538461539
1684	Sc_chr04	562014	562263	249	0.3895582329317269
1685	Sc_chr04	562263	563260	997	0.3761283851554664
1686	Sc_chr04	563260	563476	216	0.35185185185185186
1687	Sc_chr04	563476	564056	580	0.3913793103448276
1688	Sc_chr04	564056	565036	980	0.3897959183673469
1689	Sc_chr04	565036	565882	846	0.37470449172576836
1690	Sc_chr04	565882	565981	99	0.3838383838383838
1691	Sc_chr04	565981	567000	1019	0.3748773307163886
1692	Sc_chr04	567000	567120	120	0.325
1693	Sc_chr04	567120	567475	355	0.36056338028169016
1694	Sc_chr04	567475	567862	387	0.33850129198966405
1695	Sc_chr04	567862	569007	1145	0.3711790393013101
1696	Sc_chr04	569007	569109	102	0.4019607843137255
1697	Sc_chr04	569109	569325	216	0.35648148148148145
1698	Sc_chr04	569325	569628	303	0.42574257425742573
1699	Sc_chr04	569628	569687	59	0.288135593220339
1700	Sc_chr04	569687	570311	624	0.3637820512820513
1701	Sc_chr04	570311	570349	38	0.34210526315789475
1702	Sc_chr04	570349	570354	5	0.4
1703	Sc_chr04	570354	570840	486	0.3765432098765432
1704	Sc_chr04	570840	570945	105	0.4476190476190476
1705	Sc_chr04	570945	571320	375	0.368
1706	Sc_chr04	571320	571800	480	0.36875
1707	Sc_chr04	571800	572089	289	0.314878892733564
1708	Sc_chr04	572089	572493	404	0.3341584158415841
1709	Sc_chr04	572493	572841	348	0.382183908045977
1710	Sc_chr04	572841	573471	630	0.39047619047619053
1711	Sc_chr04	573471	573708	237	0.3839662447257384
1712	Sc_chr04	573708	574487	779	0.36456996148908855
1713	Sc_chr04	574487	574527	40	0.375
1714	Sc_chr04	574527	574703	176	0.39204545454545453
1715	Sc_chr04	574703	574739	36	0.38888888888888884
1716	Sc_chr04	574739	574944	205	0.3853658536585366
1717	Sc_chr04	574944	576746	1802	0.3812430632630411
1718	Sc_chr04	576746	577529	783	0.3831417624521073
1719	Sc_chr04	577529	577604	75	0.48
1720	Sc_chr04	577604	577942	338	0.4142011834319526
1721	Sc_chr04	577942	578530	588	0.31972789115646255
1722	Sc_chr04	578530	578763	233	0.32618025751072965
1723	Sc_chr04	578763	578853	90	0.41111111111111115
1724	Sc_chr04	578853	579009	156	0.4102564102564103
1725	Sc_chr04	579009	579600	591	0.3282571912013536
1726	Sc_chr04	579600	580205	605	0.3685950413223141
1727	Sc_chr04	580205	580346	141	0.3829787234042554
1728	Sc_chr04	580346	581535	1189	0.3456686291000841
1729	Sc_chr04	581535	581876	341	0.3489736070381232
1730	Sc_chr04	581876	581999	123	0.36585365853658536
1731	Sc_chr04	581999	582451	452	0.37389380530973454
1732	Sc_chr04	582451	582957	506	0.3616600790513834
1733	Sc_chr04	582957	583317	360	0.3222222222222222
1734	Sc_chr04	583317	583406	89	0.39325842696629215
1735	Sc_chr04	583406	583788	382	0.3481675392670157
1736	Sc_chr04	583788	584772	984	0.36585365853658536
1737	Sc_chr04	584772	585782	1010	0.3702970297029703
1738	Sc_chr04	585782	585899	117	0.33333333333333337
1739	Sc_chr04	585899	586086	187	0.34224598930481287
1740	Sc_chr04	586086	586514	428	0.3855140186915888
1741	Sc_chr04	586514	586530	16	0.3125
1742	Sc_chr04	586530	586986	456	0.3355263157894737
1743	Sc_chr04	586986	587072	86	0.2906976744186046
1744	Sc_chr04	587072	587583	511	0.30724070450097846
1745	Sc_chr04	587583	588823	1240	0.35806451612903223
1746	Sc_chr04	588823	588868	45	0.35555555555555557
1747	Sc_chr04	588868	588925	57	0.4035087719298246
1748	Sc_chr04	588925	589213	288	0.3472222222222222
1749	Sc_chr04	589213	589255	42	0.40476190476190477
1750	Sc_chr04	589255	589771	516	0.3178294573643411
1751	Sc_chr04	589771	590833	1062	0.4114877589453861
1752	Sc_chr04	590833	590906	73	0.3698630136986301
1753	Sc_chr04	590906	591139	233	0.38197424892703863
1754	Sc_chr04	591139	592373	1234	0.419773095623987
1755	Sc_chr04	592373	592848	475	0.38526315789473686
1756	Sc_chr04	592848	593611	763	0.41153342070773263
1757	Sc_chr04	593611	593739	128	0.4140625
1758	Sc_chr04	593739	594159	420	0.41904761904761906
1759	Sc_chr04	594159	594197	38	0.39473684210526316
1760	Sc_chr04	594197	594225	28	0.39285714285714285
1761	Sc_chr04	594225	594494	269	0.40148698884758366
1762	Sc_chr04	594494	594762	268	0.36567164179104483
1763	Sc_chr04	594762	594927	165	0.3515151515151515
1764	Sc_chr04	594927	595008	81	0.45679012345679015
1765	Sc_chr04	595008	595022	14	0.35714285714285715
1766	Sc_chr04	595022	595310	288	0.38888888888888884
1767	Sc_chr04	595310	595713	403	0.36972704714640203
1768	Sc_chr04	595713	596353	640	0.3984375
1769	Sc_chr04	596353	596394	41	0.4390243902439025
1770	Sc_chr04	596394	596551	157	0.42675159235668786
1771	Sc_chr04	596551	597326	775	0.3419354838709678
1772	Sc_chr04	597326	597812	486	0.3703703703703704
1773	Sc_chr04	597812	598577	765	0.3294117647058823
1774	Sc_chr04	598577	598893	316	0.34177215189873417
1775	Sc_chr04	598893	599110	217	0.35944700460829493
1776	Sc_chr04	599110	599240	130	0.4076923076923077
1777	Sc_chr04	599240	599469	229	0.39737991266375544
1778	Sc_chr04	599469	599532	63	0.31746031746031744
1779	Sc_chr04	599532	599952	420	0.35714285714285715
1780	Sc_chr04	599952	600421	469	0.4498933901918976
1781	Sc_chr04	600421	602142	1721	0.4177803602556653
1782	Sc_chr04	602142	602306	164	0.3719512195121951
1783	Sc_chr04	602306	602391	85	0.36470588235294116
1784	Sc_chr04	602391	602430	39	0.4102564102564103
1785	Sc_chr04	602430	603113	683	0.3396778916544656
1786	Sc_chr04	603113	603213	100	0.33
1787	Sc_chr04	603213	603501	288	0.35416666666666663
1788	Sc_chr04	603501	603771	270	0.3592592592592592
1789	Sc_chr04	603771	604043	272	0.3161764705882353
1790	Sc_chr04	604043	604360	317	0.4069400630914826
1791	Sc_chr04	604360	604470	110	0.37272727272727274
1792	Sc_chr04	604470	604518	48	0.35416666666666663
1793	Sc_chr04	604518	604545	27	0.4444444444444444
1794	Sc_chr04	604545	604556	11	0.45454545454545453
1795	Sc_chr04	604556	604857	301	0.36544850498338866
1796	Sc_chr04	604857	604919	62	0.4032258064516129
1797	Sc_chr04	604919	604955	36	0.3055555555555556
1798	Sc_chr04	604955	604977	22	0.5454545454545454
1799	Sc_chr04	604977	605026	49	0.28571428571428575
1800	Sc_chr04	605026	605094	68	0.35294117647058826
1801	Sc_chr04	605094	605210	116	0.39655172413793105
1802	Sc_chr04	605210	605351	141	0.36170212765957444
1803	Sc_chr04	605351	605519	168	0.2976190476190476
1804	Sc_chr04	605519	605589	70	0.28571428571428575
1805	Sc_chr04	605589	605881	292	0.3424657534246575
1806	Sc_chr04	605881	606541	660	0.31666666666666665
1807	Sc_chr04	606541	606754	213	0.3380281690140845
1808	Sc_chr04	606754	606773	19	0.4736842105263158
1809	Sc_chr04	606773	607121	348	0.278735632183908
1810	Sc_chr04	607121	607191	70	0.28571428571428575
1811	Sc_chr04	607191	607284	93	0.33333333333333337
1812	Sc_chr04	607284	607748	464	0.35775862068965514
1813	Sc_chr04	607748	608040	292	0.44178082191780826
1814	Sc_chr04	608040	608232	192	0.34375
1815	Sc_chr04	608232	609363	1131	0.3395225464190982
1816	Sc_chr04	609363	610154	791	0.3843236409608091
1817	Sc_chr04	610154	610944	790	0.36075949367088606
1818	Sc_chr04	610944	611292	348	0.3936781609195403
1819	Sc_chr04	611292	611402	110	0.36363636363636365
1820	Sc_chr04	611402	611594	192	0.38541666666666663
1821	Sc_chr04	611594	611844	250	0.336
1822	Sc_chr04	611844	611850	6	0.33333333333333337
1823	Sc_chr04	611850	612262	412	0.3325242718446602
1824	Sc_chr04	612262	612306	44	0.36363636363636365
1825	Sc_chr04	612306	612455	149	0.37583892617449666
1826	Sc_chr04	612455	612550	95	0.28421052631578947
1827	Sc_chr04	612550	612962	412	0.3786407766990291
1828	Sc_chr04	612962	613891	929	0.3659849300322928
1829	Sc_chr04	613891	614368	477	0.3480083857442348
1830	Sc_chr04	614368	614750	382	0.4031413612565445
1831	Sc_chr04	614750	614827	77	0.3896103896103896
1832	Sc_chr04	614827	614970	143	0.4125874125874126
1833	Sc_chr04	614970	615828	858	0.3613053613053613
1834	Sc_chr04	615828	616516	688	0.40406976744186046
1835	Sc_chr04	616516	616638	122	0.4426229508196721
1836	Sc_chr04	616638	617592	954	0.3532494758909854
1837	Sc_chr04	617592	618071	479	0.3924843423799582
1838	Sc_chr04	618071	618570	499	0.3486973947895792
1839	Sc_chr04	618570	618722	152	0.381578947368421
1840	Sc_chr04	618722	618843	121	0.371900826446281
1841	Sc_chr04	618843	619655	812	0.375615763546798
1842	Sc_chr04	619655	620742	1087	0.3551057957681693
1843	Sc_chr04	620742	621156	414	0.3502415458937198
1844	Sc_chr04	621156	621178	22	0.5454545454545454
1845	Sc_chr04	621178	621202	24	0.25
1846	Sc_chr04	621202	621358	156	0.40384615384615385
1847	Sc_chr04	621358	621384	26	0.4230769230769231
1848	Sc_chr04	621384	621473	89	0.35955056179775285
1849	Sc_chr04	621473	621928	455	0.35604395604395606
1850	Sc_chr04	621928	622123	195	0.33333333333333337
1851	Sc_chr04	622123	622590	467	0.3233404710920771
1852	Sc_chr04	622590	622654	64	0.34375
1853	Sc_chr04	622654	622748	94	0.35106382978723405
1854	Sc_chr04	622748	623078	330	0.38484848484848483
1855	Sc_chr04	623078	623338	260	0.3846153846153846
1856	Sc_chr04	623338	623428	90	0.41111111111111115
1857	Sc_chr04	623428	623448	20	0.45
1858	Sc_chr04	623448	623633	185	0.32972972972972975
1859	Sc_chr04	623633	623818	185	0.3081081081081081
1860	Sc_chr04	623818	623881	63	0.36507936507936506
1861	Sc_chr04	623881	624588	707	0.3649222065063649
1862	Sc_chr04	624588	624899	311	0.3279742765273312
1863	Sc_chr04	624899	625088	189	0.39682539682539686
1864	Sc_chr04	625088	625094	6	0.5
1865	Sc_chr04	625094	625604	510	0.3941176470588236
1866	Sc_chr04	625604	625714	110	0.43636363636363634
1867	Sc_chr04	625714	625992	278	0.39568345323741005
1868	Sc_chr04	625992	626074	82	0.25609756097560976
1869	Sc_chr04	626074	626471	397	0.35768261964735515
1870	Sc_chr04	626471	626808	337	0.344213649851632
1871	Sc_chr04	626808	627147	339	0.39233038348082594
1872	Sc_chr04	627147	627349	202	0.3465346534653465
1873	Sc_chr04	627349	627737	388	0.3943298969072165
1874	Sc_chr04	627737	628125	388	0.3505154639175258
1875	Sc_chr04	628125	628597	472	0.3919491525423729
1876	Sc_chr04	628597	628609	12	0.33333333333333337
1877	Sc_chr04	628609	628959	350	0.36857142857142855
1878	Sc_chr04	628959	629301	342	0.34210526315789475
1879	Sc_chr04	629301	629312	11	0.2727272727272727
1880	Sc_chr04	629312	630442	1130	0.363716814159292
1881	Sc_chr04	630442	630497	55	0.49090909090909096
1882	Sc_chr04	630497	630603	106	0.46226415094339623
1883	Sc_chr04	630603	630884	281	0.3309608540925267
1884	Sc_chr04	630884	630944	60	0.5
1885	Sc_chr04	630944	630989	45	0.2222222222222222
1886	Sc_chr04	630989	631339	350	0.3657142857142857
1887	Sc_chr04	631339	631494	155	0.41935483870967744
1888	Sc_chr04	631494	631716	222	0.38288288288288286
1889	Sc_chr04	631716	632559	843	0.3736654804270463
1890	Sc_chr04	632559	632672	113	0.3893805309734513
1891	Sc_chr04	632672	633154	482	0.3506224066390042
1892	Sc_chr04	633154	633257	103	0.3980582524271845
1893	Sc_chr04	633257	633593	336	0.3898809523809524
1894	Sc_chr04	633593	633607	14	0.35714285714285715
1895	Sc_chr04	633607	633685	78	0.34615384615384615
1896	Sc_chr04	633685	633777	92	0.45652173913043476
1897	Sc_chr04	633777	633893	116	0.42241379310344823
1898	Sc_chr04	633893	633977	84	0.39285714285714285
1899	Sc_chr04	633977	634059	82	0.40243902439024387
1900	Sc_chr04	634059	634302	243	0.45267489711934156
1901	Sc_chr04	634302	634555	253	0.40711462450592883
1902	Sc_chr04	634555	634970	415	0.4433734939759036
1903	Sc_chr04	634970	635636	666	0.42342342342342343
1904	Sc_chr04	635636	635938	302	0.49668874172185434
1905	Sc_chr04	635938	635982	44	0.5454545454545454
1906	Sc_chr04	635982	636060	78	0.5384615384615384
1907	Sc_chr04	636060	636573	513	0.49512670565302147
1908	Sc_chr04	636573	638065	1492	0.3505361930294906
1909	Sc_chr04	638065	638467	402	0.373134328358209
1910	Sc_chr04	638467	639254	787	0.409148665819568
1911	Sc_chr04	639254	639604	350	0.3457142857142857
1912	Sc_chr04	639604	641246	1642	0.35627283800243603
1913	Sc_chr04	641246	642540	1294	0.34930448222565685
1914	Sc_chr04	642540	642660	120	0.4
1915	Sc_chr04	642660	642945	285	0.368421052631579
1916	Sc_chr04	642945	642957	12	0.5
1917	Sc_chr04	642957	643082	125	0.41600000000000004
1918	Sc_chr04	643082	644583	1501	0.38374417055296467
1919	Sc_chr04	644583	644638	55	0.4
1920	Sc_chr04	644638	644905	267	0.40449438202247195
1921	Sc_chr04	644905	645185	280	0.3821428571428572
1922	Sc_chr04	645185	645413	228	0.3640350877192982
1923	Sc_chr04	645413	645683	270	0.3074074074074074
1924	Sc_chr04	645683	645854	171	0.30994152046783624
1925	Sc_chr04	645854	646055	201	0.3034825870646766
1926	Sc_chr04	646055	646062	7	0.42857142857142855
1927	Sc_chr04	646062	646706	644	0.3555900621118013
1928	Sc_chr04	646706	647499	793	0.34047919293820933
1929	Sc_chr04	647499	647583	84	0.34523809523809523
1930	Sc_chr04	647583	647719	136	0.39705882352941174
1931	Sc_chr04	647719	647734	15	0.6
1932	Sc_chr04	647734	648114	380	0.4210526315789474
1933	Sc_chr04	648114	648331	217	0.4147465437788018
1934	Sc_chr04	648331	648347	16	0.375
1935	Sc_chr04	648347	648433	86	0.37209302325581395
1936	Sc_chr04	648433	648592	159	0.40880503144654085
1937	Sc_chr04	648592	649479	887	0.39571589627959414
1938	Sc_chr04	649479	649713	234	0.3846153846153846
1939	Sc_chr04	649713	650068	355	0.4112676056338028
1940	Sc_chr04	650068	650490	422	0.3696682464454976
1941	Sc_chr04	650490	651032	542	0.4446494464944649
1942	Sc_chr04	651032	651267	235	0.32340425531914896
1943	Sc_chr04	651267	651550	283	0.2968197879858657
1944	Sc_chr04	651550	651766	216	0.36574074074074076
1945	Sc_chr04	651766	651774	8	0.5
1946	Sc_chr04	651774	652563	789	0.3409378960709759
1947	Sc_chr04	652563	652719	156	0.3205128205128205
1948	Sc_chr04	652719	653254	535	0.3551401869158879
1949	Sc_chr04	653254	653803	549	0.35154826958105645
1950	Sc_chr04	653803	654268	465	0.3827956989247312
1951	Sc_chr04	654268	654335	67	0.373134328358209
1952	Sc_chr04	654335	654807	472	0.3199152542372881
1953	Sc_chr04	654807	654996	189	0.4232804232804233
1954	Sc_chr04	654996	655808	812	0.3657635467980295
1955	Sc_chr04	655808	656593	785	0.36305732484076436
1956	Sc_chr04	656593	656769	176	0.42613636363636365
1957	Sc_chr04	656769	657329	560	0.41607142857142854
1958	Sc_chr04	657329	657931	602	0.3554817275747509
1959	Sc_chr04	657931	659801	1870	0.3780748663101604
1960	Sc_chr04	659801	660193	392	0.35714285714285715
1961	Sc_chr04	660193	660296	103	0.31067961165048547
1962	Sc_chr04	660296	660324	28	0.32142857142857145
1963	Sc_chr04	660324	660744	420	0.35
1964	Sc_chr04	660744	661255	511	0.3522504892367906
1965	Sc_chr04	661255	661272	17	0.411764705882353
1966	Sc_chr04	661272	661328	56	0.4107142857142857
1967	Sc_chr04	661328	661527	199	0.4120603015075377
1968	Sc_chr04	661527	661566	39	0.6153846153846154
1969	Sc_chr04	661566	661594	28	0.32142857142857145
1970	Sc_chr04	661594	661710	116	0.4310344827586207
1971	Sc_chr04	661710	661886	176	0.38636363636363635
1972	Sc_chr04	661886	662278	392	0.375
1973	Sc_chr04	662278	662368	90	0.37777777777777777
1974	Sc_chr04	662368	663023	655	0.34045801526717556
1975	Sc_chr04	663023	663388	365	0.3643835616438356
1976	Sc_chr04	663388	663405	17	0.5294117647058824
1977	Sc_chr04	663405	663542	137	0.34306569343065696
1978	Sc_chr04	663542	664020	478	0.37238493723849375
1979	Sc_chr04	664020	664219	199	0.38190954773869346
1980	Sc_chr04	664219	664276	57	0.2631578947368421
1981	Sc_chr04	664276	664399	123	0.3983739837398374
1982	Sc_chr04	664399	664577	178	0.39325842696629215
1983	Sc_chr04	664577	664696	119	0.35294117647058826
1984	Sc_chr04	664696	665105	409	0.39119804400978
1985	Sc_chr04	665105	665123	18	0.5
1986	Sc_chr04	665123	665211	88	0.2727272727272727
1987	Sc_chr04	665211	665682	471	0.36518046709129515
1988	Sc_chr04	665682	665901	219	0.3972602739726028
1989	Sc_chr04	665901	666026	125	0.44
1990	Sc_chr04	666026	666660	634	0.38170347003154576
1991	Sc_chr04	666660	668019	1359	0.3649742457689477
1992	Sc_chr04	668019	668031	12	0.5833333333333334
1993	Sc_chr04	668031	668086	55	0.5272727272727272
1994	Sc_chr04	668086	668258	172	0.3430232558139535
1995	Sc_chr04	668258	669276	1018	0.29960707269155207
1996	Sc_chr04	669276	669403	127	0.31496062992125984
1997	Sc_chr04	669403	669763	360	0.39166666666666666
1998	Sc_chr04	669763	669814	51	0.35294117647058826
1999	Sc_chr04	669814	669895	81	0.4444444444444444
2000	Sc_chr04	669895	670019	124	0.4274193548387097
2001	Sc_chr04	670019	670267	248	0.38306451612903225
2002	Sc_chr04	670267	670328	61	0.39344262295081966
2003	Sc_chr04	670328	671490	1162	0.3717728055077453
2004	Sc_chr04	671490	671693	203	0.41379310344827586
2005	Sc_chr04	671693	671955	262	0.30916030534351147
2006	Sc_chr04	671955	672281	326	0.35582822085889565
2007	Sc_chr04	672281	672689	408	0.375
2008	Sc_chr04	672689	673047	358	0.3966480446927374
2009	Sc_chr04	673047	673077	30	0.4666666666666666
2010	Sc_chr04	673077	673232	155	0.39354838709677414
2011	Sc_chr04	673232	673896	664	0.35542168674698793
2012	Sc_chr04	673896	674304	408	0.3946078431372549
2013	Sc_chr04	674304	674318	14	0.5
2014	Sc_chr04	674318	674375	57	0.33333333333333337
2015	Sc_chr04	674375	674499	124	0.3870967741935484
2016	Sc_chr04	674499	674879	380	0.45526315789473687
2017	Sc_chr04	674879	675498	619	0.38610662358642966
2018	Sc_chr04	675498	675564	66	0.46969696969696967
2019	Sc_chr04	675564	675837	273	0.3992673992673993
2020	Sc_chr04	675837	676227	390	0.382051282051282
2021	Sc_chr04	676227	676980	753	0.34395750332005315
2022	Sc_chr04	676980	677448	468	0.3675213675213675
2023	Sc_chr04	677448	677631	183	0.453551912568306
2024	Sc_chr04	677631	677664	33	0.3939393939393939
2025	Sc_chr04	677664	677763	99	0.40404040404040403
2026	Sc_chr04	677763	677976	213	0.3004694835680751
2027	Sc_chr04	677976	678599	623	0.3563402889245586
2028	Sc_chr04	678599	678948	349	0.3954154727793696
2029	Sc_chr04	678948	678957	9	0.33333333333333337
2030	Sc_chr04	678957	679035	78	0.4487179487179487
2031	Sc_chr04	679035	679520	485	0.4494845360824742
2032	Sc_chr04	679520	679913	393	0.3918575063613232
2033	Sc_chr04	679913	680295	382	0.33507853403141363
2034	Sc_chr04	680295	680492	197	0.4467005076142132
2035	Sc_chr04	680492	680524	32	0.375
2036	Sc_chr04	680524	681091	567	0.4162257495590829
2037	Sc_chr04	681091	681330	239	0.35146443514644354
2038	Sc_chr04	681330	681805	475	0.3978947368421053
2039	Sc_chr04	681805	682037	232	0.34913793103448276
2040	Sc_chr04	682037	682045	8	0.5
2041	Sc_chr04	682045	682866	821	0.3605359317904994
2042	Sc_chr04	682866	682931	65	0.4615384615384615
2043	Sc_chr04	682931	683118	187	0.41711229946524064
2044	Sc_chr04	683118	683560	442	0.42986425339366513
2045	Sc_chr04	683560	684019	459	0.3115468409586057
2046	Sc_chr04	684019	684026	7	0.28571428571428575
2047	Sc_chr04	684026	684099	73	0.4246575342465754
2048	Sc_chr04	684099	684394	295	0.3728813559322034
2049	Sc_chr04	684394	684526	132	0.3939393939393939
2050	Sc_chr04	684526	684805	279	0.3727598566308244
2051	Sc_chr04	684805	685198	393	0.361323155216285
2052	Sc_chr04	685198	685285	87	0.41379310344827586
2053	Sc_chr04	685285	685298	13	0.5384615384615384
2054	Sc_chr04	685298	685370	72	0.3472222222222222
2055	Sc_chr04	685370	685980	610	0.36721311475409835
2056	Sc_chr04	685980	686090	110	0.37272727272727274
2057	Sc_chr04	686090	686334	244	0.36065573770491804
2058	Sc_chr04	686334	686750	416	0.3365384615384615
2059	Sc_chr04	686750	687144	394	0.34517766497461927
2060	Sc_chr04	687144	687885	741	0.3616734143049933
2061	Sc_chr04	687885	688580	695	0.3755395683453237
2062	Sc_chr04	688580	688656	76	0.381578947368421
2063	Sc_chr04	688656	688955	299	0.431438127090301
2064	Sc_chr04	688955	690665	1710	0.3678362573099415
2065	Sc_chr04	690665	690677	12	0.25
2066	Sc_chr04	690677	691035	358	0.36312849162011174
2067	Sc_chr04	691035	691372	337	0.3857566765578635
2068	Sc_chr04	691372	691503	131	0.3206106870229008
2069	Sc_chr04	691503	692621	1118	0.4150268336314848
2070	Sc_chr04	692621	693047	426	0.38967136150234744
2071	Sc_chr04	693047	693304	257	0.3696498054474708
2072	Sc_chr04	693304	693414	110	0.3363636363636363
2073	Sc_chr04	693414	694221	807	0.40768277571251554
2074	Sc_chr04	694221	695763	1542	0.40012970168612194
2075	Sc_chr04	695763	695842	79	0.34177215189873417
2076	Sc_chr04	695842	696049	207	0.3961352657004831
2077	Sc_chr04	696049	696589	540	0.4388888888888889
2078	Sc_chr04	696589	697547	958	0.4123173277661795
2079	Sc_chr04	697547	697551	4	0.5
2080	Sc_chr04	697551	698150	599	0.3606010016694491
2081	Sc_chr04	698150	699001	851	0.4030552291421856
2082	Sc_chr04	699001	699155	154	0.41558441558441556
2083	Sc_chr04	699155	699425	270	0.44074074074074077
2084	Sc_chr04	699425	699937	512	0.421875
2085	Sc_chr04	699937	699969	32	0.3125
2086	Sc_chr04	699969	700491	522	0.4099616858237548
2087	Sc_chr04	700491	700547	56	0.32142857142857145
2088	Sc_chr04	700547	700563	16	0.4375
2089	Sc_chr04	700563	700770	207	0.42028985507246375
2090	Sc_chr04	700770	701108	338	0.3698224852071006
2091	Sc_chr04	701108	701223	115	0.3826086956521739
2092	Sc_chr04	701223	702236	1013	0.3405725567620928
2093	Sc_chr04	702236	703496	1260	0.35714285714285715
2094	Sc_chr04	703496	703572	76	0.4473684210526316
2095	Sc_chr04	703572	703652	80	0.4
2096	Sc_chr04	703652	703669	17	0.5294117647058824
2097	Sc_chr04	703669	704020	351	0.4045584045584046
2098	Sc_chr04	704020	704097	77	0.41558441558441556
2099	Sc_chr04	704097	704403	306	0.3790849673202614
2100	Sc_chr04	704403	704800	397	0.3778337531486146
2101	Sc_chr04	704800	705215	415	0.3855421686746988
2102	Sc_chr04	705215	705722	507	0.4023668639053255
2103	Sc_chr04	705722	706721	999	0.4044044044044044
2104	Sc_chr04	706721	706937	216	0.41666666666666663
2105	Sc_chr04	706937	707507	570	0.4070175438596491
2106	Sc_chr04	707507	707643	136	0.4411764705882353
2107	Sc_chr04	707643	707706	63	0.38095238095238093
2108	Sc_chr04	707706	708058	352	0.38636363636363635
2109	Sc_chr04	708058	708441	383	0.39686684073107054
2110	Sc_chr04	708441	708838	397	0.40554156171284633
2111	Sc_chr04	708838	709149	311	0.4115755627009646
2112	Sc_chr04	709149	709707	558	0.3745519713261649
2113	Sc_chr04	709707	710020	313	0.4185303514376997
2114	Sc_chr04	710020	710055	35	0.42857142857142855
2115	Sc_chr04	710055	710476	421	0.38717339667458434
2116	Sc_chr04	710476	710508	32	0.5
2117	Sc_chr04	710508	711225	717	0.3709902370990237
2118	Sc_chr04	711225	711418	193	0.3886010362694301
2119	Sc_chr04	711418	712059	641	0.3837753510140406
2120	Sc_chr04	712059	712297	238	0.37815126050420167
2121	Sc_chr04	712297	712793	496	0.3991935483870968
2122	Sc_chr04	712793	713509	716	0.3743016759776536
2123	Sc_chr04	713509	713592	83	0.4216867469879518
2124	Sc_chr04	713592	713772	180	0.37222222222222223
2125	Sc_chr04	713772	713986	214	0.43457943925233644
2126	Sc_chr04	713986	714527	541	0.4029574861367837
2127	Sc_chr04	714527	714710	183	0.3551912568306011
2128	Sc_chr04	714710	715216	506	0.43280632411067194
2129	Sc_chr04	715216	715619	403	0.36476426799007444
2130	Sc_chr04	715619	716300	681	0.3744493392070485
2131	Sc_chr04	716300	716313	13	0.3846153846153846
2132	Sc_chr04	716313	717164	851	0.36780258519388953
2133	Sc_chr04	717164	717797	633	0.37598736176935227
2134	Sc_chr04	717797	717874	77	0.33766233766233766
2135	Sc_chr04	717874	717895	21	0.5238095238095238
2136	Sc_chr04	717895	718027	132	0.36363636363636365
2137	Sc_chr04	718027	718047	20	0.3
2138	Sc_chr04	718047	718365	318	0.3238993710691824
2139	Sc_chr04	718365	718970	605	0.33057851239669417
2140	Sc_chr04	718970	719663	693	0.36363636363636365
2141	Sc_chr04	719663	719716	53	0.45283018867924524
2142	Sc_chr04	719716	719920	204	0.338235294117647
2143	Sc_chr04	719920	720021	101	0.3564356435643565
2144	Sc_chr04	720021	720043	22	0.40909090909090906
2145	Sc_chr04	720043	720254	211	0.3744075829383886
2146	Sc_chr04	720254	720637	383	0.3550913838120105
2147	Sc_chr04	720637	721603	966	0.3612836438923395
2148	Sc_chr04	721603	721994	391	0.45012787723785164
2149	Sc_chr04	721994	722675	681	0.4023494860499266
2150	Sc_chr04	722675	722810	135	0.4222222222222222
2151	Sc_chr04	722810	723446	636	0.40094339622641506
2152	Sc_chr04	723446	723692	246	0.3943089430894309
2153	Sc_chr04	723692	724600	908	0.38986784140969166
2154	Sc_chr04	724600	725175	575	0.39304347826086955
2155	Sc_chr04	725175	725216	41	0.5121951219512195
2156	Sc_chr04	725216	725298	82	0.40243902439024387
2157	Sc_chr04	725298	725348	50	0.4
2158	Sc_chr04	725348	725373	25	0.44
2159	Sc_chr04	725373	725513	140	0.37857142857142856
2160	Sc_chr04	725513	726697	1184	0.35219594594594594
2161	Sc_chr04	726697	727168	471	0.35244161358811044
2162	Sc_chr04	727168	727440	272	0.3455882352941177
2163	Sc_chr04	727440	727507	67	0.44776119402985076
2164	Sc_chr04	727507	727646	139	0.381294964028777
2165	Sc_chr04	727646	727895	249	0.36947791164658633
2166	Sc_chr04	727895	728118	223	0.36771300448430494
2167	Sc_chr04	728118	728311	193	0.3886010362694301
2168	Sc_chr04	728311	729512	1201	0.36303080766028306
2169	Sc_chr04	729512	729821	309	0.36893203883495146
2170	Sc_chr04	729821	730014	193	0.3678756476683938
2171	Sc_chr04	730014	730124	110	0.34545454545454546
2172	Sc_chr04	730124	730489	365	0.36164383561643837
2173	Sc_chr04	730489	730511	22	0.40909090909090906
2174	Sc_chr04	730511	730597	86	0.3023255813953488
2175	Sc_chr04	730597	730905	308	0.3279220779220779
2176	Sc_chr04	730905	731247	342	0.3567251461988304
2177	Sc_chr04	731247	731295	48	0.375
2178	Sc_chr04	731295	731386	91	0.4065934065934066
2179	Sc_chr04	731386	731433	47	0.2978723404255319
2180	Sc_chr04	731433	732043	610	0.3557377049180328
2181	Sc_chr04	732043	732336	293	0.3651877133105802
2182	Sc_chr04	732336	732701	365	0.4
2183	Sc_chr04	732701	732923	222	0.3603603603603604
2184	Sc_chr04	732923	733860	937	0.35325506937033085
2185	Sc_chr04	733860	733885	25	0.44
2186	Sc_chr04	733885	734291	406	0.3645320197044335
2187	Sc_chr04	734291	734543	252	0.38888888888888884
2188	Sc_chr04	734543	734923	380	0.3631578947368421
2189	Sc_chr04	734923	735088	165	0.3757575757575758
2190	Sc_chr04	735088	735194	106	0.330188679245283
2191	Sc_chr04	735194	735280	86	0.38372093023255816
2192	Sc_chr04	735280	735347	67	0.2985074626865672
2193	Sc_chr04	735347	735410	63	0.31746031746031744
2194	Sc_chr04	735410	735709	299	0.3678929765886288
2195	Sc_chr04	735709	735925	216	0.3703703703703704
2196	Sc_chr04	735925	736467	542	0.36162361623616235
2197	Sc_chr04	736467	736478	11	0.36363636363636365
2198	Sc_chr04	736478	737503	1025	0.3619512195121951
2199	Sc_chr04	737503	737589	86	0.2906976744186046
2200	Sc_chr04	737589	737728	139	0.35251798561151076
2201	Sc_chr04	737728	737863	135	0.34814814814814815
2202	Sc_chr04	737863	738072	209	0.33492822966507174
2203	Sc_chr04	738072	738211	139	0.3237410071942446
2204	Sc_chr04	738211	739640	1429	0.370888733379986
2205	Sc_chr04	739640	740005	365	0.3863013698630137
2206	Sc_chr04	740005	740113	108	0.3703703703703704
2207	Sc_chr04	740113	740152	39	0.33333333333333337
2208	Sc_chr04	740152	740391	239	0.3430962343096234
2209	Sc_chr04	740391	740660	269	0.3568773234200744
2210	Sc_chr04	740660	741134	474	0.3924050632911393
2211	Sc_chr04	741134	741217	83	0.3734939759036145
2212	Sc_chr04	741217	741404	187	0.37967914438502676
2213	Sc_chr04	741404	741461	57	0.3157894736842105
2214	Sc_chr04	741461	741649	188	0.39893617021276595
2215	Sc_chr04	741649	742051	402	0.3233830845771144
2216	Sc_chr04	742051	742277	226	0.4424778761061947
2217	Sc_chr04	742277	742487	210	0.4238095238095238
2218	Sc_chr04	742487	743025	538	0.466542750929368
2219	Sc_chr04	743025	743405	380	0.4052631578947368
2220	Sc_chr04	743405	744723	1318	0.381638846737481
2221	Sc_chr04	744723	744777	54	0.35185185185185186
2222	Sc_chr04	744777	745036	259	0.4092664092664093
2223	Sc_chr04	745036	745125	89	0.39325842696629215
2224	Sc_chr04	745125	745197	72	0.4444444444444444
2225	Sc_chr04	745197	745467	270	0.3851851851851852
2226	Sc_chr04	745467	745513	46	0.5217391304347826
2227	Sc_chr04	745513	745788	275	0.41090909090909095
2228	Sc_chr04	745788	746805	1017	0.36971484759095374
2229	Sc_chr04	746805	746949	144	0.45833333333333337
2230	Sc_chr04	746949	747872	923	0.39653304442036835
2231	Sc_chr04	747872	748078	206	0.4077669902912621
2232	Sc_chr04	748078	748689	611	0.29132569558101473
2233	Sc_chr04	748689	748722	33	0.36363636363636365
2234	Sc_chr04	748722	748992	270	0.37777777777777777
2235	Sc_chr04	748992	749010	18	0.5
2236	Sc_chr04	749010	749036	26	0.3076923076923077
2237	Sc_chr04	749036	749228	192	0.35416666666666663
2238	Sc_chr04	749228	749682	454	0.40969162995594716
2239	Sc_chr04	749682	750052	370	0.3945945945945946
2240	Sc_chr04	750052	750821	769	0.3524057217165149
2241	Sc_chr04	750821	750948	127	0.36220472440944884
2242	Sc_chr04	750948	750984	36	0.33333333333333337
2243	Sc_chr04	750984	751612	628	0.36305732484076436
2244	Sc_chr04	751612	751758	146	0.4657534246575342
2245	Sc_chr04	751758	752284	526	0.3688212927756654
2246	Sc_chr04	752284	752365	81	0.30864197530864196
2247	Sc_chr04	752365	752392	27	0.48148148148148145
2248	Sc_chr04	752392	752400	8	0.5
2249	Sc_chr04	752400	753763	1363	0.31107850330154074
2250	Sc_chr04	753763	754438	675	0.42814814814814817
2251	Sc_chr04	754438	755305	867	0.405997693194925
2252	Sc_chr04	755305	755546	241	0.42323651452282157
2253	Sc_chr04	755546	756269	723	0.3775933609958506
2254	Sc_chr04	756269	756374	105	0.2761904761904762
2255	Sc_chr04	756374	756536	162	0.30246913580246915
2256	Sc_chr04	756536	756586	50	0.4
2257	Sc_chr04	756586	756641	55	0.45454545454545453
2258	Sc_chr04	756641	756787	146	0.3013698630136986
2259	Sc_chr04	756787	756977	190	0.34210526315789475
2260	Sc_chr04	756977	757208	231	0.33766233766233766
2261	Sc_chr04	757208	757847	639	0.40845070422535207
2262	Sc_chr04	757847	758060	213	0.43661971830985913
2263	Sc_chr04	758060	758252	192	0.43229166666666663
2264	Sc_chr04	758252	758444	192	0.421875
2265	Sc_chr04	758444	759212	768	0.42838541666666663
2266	Sc_chr04	759212	759404	192	0.42708333333333337
2267	Sc_chr04	759404	759805	401	0.4139650872817955
2268	Sc_chr04	759805	759948	143	0.3776223776223776
2269	Sc_chr04	759948	760250	302	0.3410596026490066
2270	Sc_chr04	760250	760613	363	0.3746556473829201
2271	Sc_chr04	760613	760781	168	0.3392857142857143
2272	Sc_chr04	760781	761488	707	0.347949080622348
2273	Sc_chr04	761488	761753	265	0.37735849056603776
2274	Sc_chr04	761753	761762	9	0.2222222222222222
2275	Sc_chr04	761762	762293	531	0.3860640301318267
2276	Sc_chr04	762293	762299	6	0.33333333333333337
2277	Sc_chr04	762299	762347	48	0.33333333333333337
2278	Sc_chr04	762347	762545	198	0.40404040404040403
2279	Sc_chr04	762545	762587	42	0.5
2280	Sc_chr04	762587	763269	682	0.37976539589442815
2281	Sc_chr04	763269	763715	446	0.3946188340807175
2282	Sc_chr04	763715	763851	136	0.42647058823529416
2283	Sc_chr04	763851	763976	125	0.28
2284	Sc_chr04	763976	764849	873	0.3528064146620848
2285	Sc_chr04	764849	765064	215	0.37674418604651166
2286	Sc_chr04	765064	765074	10	0.3
2287	Sc_chr04	765074	765322	248	0.41935483870967744
2288	Sc_chr04	765322	765357	35	0.34285714285714286
2289	Sc_chr04	765357	765386	29	0.3793103448275862
2290	Sc_chr04	765386	765773	387	0.3850129198966408
2291	Sc_chr04	765773	767085	1312	0.3826219512195122
2292	Sc_chr04	767085	767149	64	0.359375
2293	Sc_chr04	767149	767582	433	0.3833718244803695
2294	Sc_chr04	767582	768191	609	0.36288998357963875
2295	Sc_chr04	768191	770080	1889	0.4621492853361567
2296	Sc_chr04	770080	770474	394	0.33756345177664976
2297	Sc_chr04	770474	771567	1093	0.4107959743824337
2298	Sc_chr04	771567	772207	640	0.353125
2299	Sc_chr04	772207	772284	77	0.35064935064935066
2300	Sc_chr04	772284	772316	32	0.40625
2301	Sc_chr04	772316	772341	25	0.36
2302	Sc_chr04	772341	772390	49	0.28571428571428575
2303	Sc_chr04	772390	772440	50	0.42
2304	Sc_chr04	772440	772501	61	0.3770491803278688
2305	Sc_chr04	772501	772738	237	0.3839662447257384
2306	Sc_chr04	772738	772826	88	0.40909090909090906
2307	Sc_chr04	772826	773663	837	0.33452807646356036
2308	Sc_chr04	773663	773865	202	0.40099009900990096
2309	Sc_chr04	773865	774656	791	0.3527180783817952
2310	Sc_chr04	774656	775206	550	0.3218181818181818
2311	Sc_chr04	775206	775695	489	0.39059304703476483
2312	Sc_chr04	775695	775739	44	0.38636363636363635
2313	Sc_chr04	775739	775745	6	0.33333333333333337
2314	Sc_chr04	775745	776928	1183	0.35756551141166526
2315	Sc_chr04	776928	777487	559	0.3989266547406082
2316	Sc_chr04	777487	777851	364	0.40384615384615385
2317	Sc_chr04	777851	778601	750	0.37866666666666665
2318	Sc_chr04	778601	779255	654	0.3180428134556575
2319	Sc_chr04	779255	779705	450	0.4066666666666666
2320	Sc_chr04	779705	780110	405	0.37777777777777777
2321	Sc_chr04	780110	780633	523	0.37093690248565964
2322	Sc_chr04	780633	781795	1162	0.3984509466437177
2323	Sc_chr04	781795	782038	243	0.34156378600823045
2324	Sc_chr04	782038	782261	223	0.4304932735426009
2325	Sc_chr04	782261	782384	123	0.3252032520325204
2326	Sc_chr04	782384	782702	318	0.380503144654088
2327	Sc_chr04	782702	782766	64	0.328125
2328	Sc_chr04	782766	782969	203	0.30049261083743845
2329	Sc_chr04	782969	783164	195	0.3948717948717949
2330	Sc_chr04	783164	783187	23	0.391304347826087
2331	Sc_chr04	783187	783293	106	0.37735849056603776
2332	Sc_chr04	783293	783822	529	0.389413988657845
2333	Sc_chr04	783822	784325	503	0.34592445328031807
2334	Sc_chr04	784325	784451	126	0.42857142857142855
2335	Sc_chr04	784451	784533	82	0.32926829268292684
2336	Sc_chr04	784533	785737	1204	0.3646179401993356
2337	Sc_chr04	785737	785899	162	0.3148148148148148
2338	Sc_chr04	785899	786644	745	0.33825503355704695
2339	Sc_chr04	786644	786755	111	0.33333333333333337
2340	Sc_chr04	786755	786977	222	0.31981981981981983
2341	Sc_chr04	786977	787105	128	0.3359375
2342	Sc_chr04	787105	787643	538	0.3643122676579926
2343	Sc_chr04	787643	787685	42	0.28571428571428575
2344	Sc_chr04	787685	787780	95	0.28421052631578947
2345	Sc_chr04	787780	788329	549	0.3296903460837887
2346	Sc_chr04	788329	788836	507	0.31163708086785014
2347	Sc_chr04	788836	788977	141	0.36170212765957444
2348	Sc_chr04	788977	789846	869	0.3762945914844649
2349	Sc_chr04	789846	790006	160	0.48125
2350	Sc_chr04	790006	790219	213	0.3661971830985915
2351	Sc_chr04	790219	790636	417	0.3621103117505995
2352	Sc_chr04	790636	790672	36	0.36111111111111116
2353	Sc_chr04	790672	790770	98	0.37755102040816324
2354	Sc_chr04	790770	791014	244	0.38114754098360654
2355	Sc_chr04	791014	791354	340	0.35
2356	Sc_chr04	791354	791515	161	0.32298136645962733
2357	Sc_chr04	791515	791694	179	0.29608938547486036
2358	Sc_chr04	791694	791731	37	0.2972972972972973
2359	Sc_chr04	791731	791950	219	0.36073059360730597
2360	Sc_chr04	791950	792788	838	0.3460620525059666
2361	Sc_chr04	792788	792819	31	0.3225806451612903
2362	Sc_chr04	792819	793153	334	0.4101796407185629
2363	Sc_chr04	793153	794154	1001	0.39760239760239763
2364	Sc_chr04	794154	794376	222	0.44144144144144143
2365	Sc_chr04	794376	794538	162	0.4012345679012346
2366	Sc_chr04	794538	794628	90	0.43333333333333335
2367	Sc_chr04	794628	795189	561	0.39928698752228164
2368	Sc_chr04	795189	795779	590	0.3966101694915254
2369	Sc_chr04	795779	796080	301	0.33222591362126247
2370	Sc_chr04	796080	796453	373	0.3646112600536193
2371	Sc_chr04	796453	797112	659	0.3960546282245827
2372	Sc_chr04	797112	797237	125	0.32799999999999996
2373	Sc_chr04	797237	797555	318	0.3679245283018868
2374	Sc_chr04	797555	797584	29	0.3793103448275862
2375	Sc_chr04	797584	798240	656	0.3628048780487805
2376	Sc_chr04	798240	798545	305	0.3508196721311475
2377	Sc_chr04	798545	798683	138	0.427536231884058
2378	Sc_chr04	798683	799342	659	0.34446130500758726
2379	Sc_chr04	799342	799802	460	0.38913043478260867
2380	Sc_chr04	799802	799886	84	0.35714285714285715
2381	Sc_chr04	799886	800162	276	0.3768115942028985
2382	Sc_chr04	800162	800595	433	0.3510392609699769
2383	Sc_chr04	800595	800739	144	0.3819444444444444
2384	Sc_chr04	800739	800940	201	0.4129353233830846
2385	Sc_chr04	800940	801249	309	0.4045307443365696
2386	Sc_chr04	801249	801302	53	0.4716981132075472
2387	Sc_chr04	801302	801438	136	0.39705882352941174
2388	Sc_chr04	801438	802077	639	0.4194053208137715
2389	Sc_chr04	802077	802763	686	0.34985422740524785
2390	Sc_chr04	802763	803284	521	0.33397312859884837
2391	Sc_chr04	803284	804205	921	0.40499457111834963
2392	Sc_chr04	804205	804436	231	0.3852813852813853
2393	Sc_chr04	804436	804449	13	0.3846153846153846
2394	Sc_chr04	804449	804603	154	0.42857142857142855
2395	Sc_chr04	804603	804837	234	0.37606837606837606
2396	Sc_chr04	804837	806029	1192	0.3691275167785235
2397	Sc_chr04	806029	806493	464	0.4482758620689655
2398	Sc_chr04	806493	806600	107	0.37383177570093457
2399	Sc_chr04	806600	807474	874	0.4496567505720824
2400	Sc_chr04	807474	807513	39	0.3846153846153846
2401	Sc_chr04	807513	807675	162	0.4074074074074074
2402	Sc_chr04	807675	808062	387	0.34883720930232553
2403	Sc_chr04	808062	808149	87	0.3103448275862069
2404	Sc_chr04	808149	809036	887	0.4227733934611049
2405	Sc_chr04	809036	809097	61	0.39344262295081966
2406	Sc_chr04	809097	809387	290	0.39655172413793105
2407	Sc_chr04	809387	809691	304	0.444078947368421
2408	Sc_chr04	809691	809700	9	0.4444444444444444
2409	Sc_chr04	809700	809820	120	0.4666666666666666
2410	Sc_chr04	809820	810330	510	0.37254901960784315
2411	Sc_chr04	810330	810421	91	0.3076923076923077
2412	Sc_chr04	810421	811007	586	0.3242320819112628
2413	Sc_chr04	811007	811147	140	0.37142857142857144
2414	Sc_chr04	811147	811721	574	0.40243902439024387
2415	Sc_chr04	811721	812118	397	0.4508816120906801
2416	Sc_chr04	812118	812402	284	0.45070422535211263
2417	Sc_chr04	812402	812412	10	0.5
2418	Sc_chr04	812412	812779	367	0.44141689373297005
2419	Sc_chr04	812779	813212	433	0.3071593533487298
2420	Sc_chr04	813212	813467	255	0.3764705882352941
2421	Sc_chr04	813467	814004	537	0.3985102420856611
2422	Sc_chr04	814004	814214	210	0.40476190476190477
2423	Sc_chr04	814214	814697	483	0.4057971014492754
2424	Sc_chr04	814697	814982	285	0.3894736842105263
2425	Sc_chr04	814982	815102	120	0.4
2426	Sc_chr04	815102	815267	165	0.36363636363636365
2427	Sc_chr04	815267	815372	105	0.3523809523809524
2428	Sc_chr04	815372	816751	1379	0.3727338651196519
2429	Sc_chr04	816751	816925	174	0.3563218390804597
2430	Sc_chr04	816925	817234	309	0.4207119741100323
2431	Sc_chr04	817234	817387	153	0.411764705882353
2432	Sc_chr04	817387	817632	245	0.37142857142857144
2433	Sc_chr04	817632	817800	168	0.3869047619047619
2434	Sc_chr04	817800	817819	19	0.6842105263157895
2435	Sc_chr04	817819	817901	82	0.34146341463414637
2436	Sc_chr04	817901	817962	61	0.4098360655737705
2437	Sc_chr04	817962	819023	1061	0.37040527803958534
2438	Sc_chr04	819023	819060	37	0.35135135135135137
2439	Sc_chr04	819060	819111	51	0.3137254901960784
2440	Sc_chr04	819111	819156	45	0.26666666666666666
2441	Sc_chr04	819156	820239	1083	0.332409972299169
2442	Sc_chr04	820239	820460	221	0.3438914027149321
2443	Sc_chr04	820460	820698	238	0.3445378151260504
2444	Sc_chr04	820698	820734	36	0.4444444444444444
2445	Sc_chr04	820734	821852	1118	0.3765652951699463
2446	Sc_chr04	821852	822512	660	0.32878787878787874
2447	Sc_chr04	822512	822716	204	0.29901960784313725
2448	Sc_chr04	822716	822851	135	0.31851851851851853
2449	Sc_chr04	822851	823135	284	0.3204225352112676
2450	Sc_chr04	823135	823189	54	0.4444444444444444
2451	Sc_chr04	823189	823385	196	0.326530612244898
2452	Sc_chr04	823385	823440	55	0.32727272727272727
2453	Sc_chr04	823440	824735	1295	0.35366795366795367
2454	Sc_chr04	824735	824777	42	0.2380952380952381
2455	Sc_chr04	824777	824963	186	0.3709677419354838
2456	Sc_chr04	824963	825113	150	0.34
2457	Sc_chr04	825113	825221	108	0.32407407407407407
2458	Sc_chr04	825221	826481	1260	0.35
2459	Sc_chr04	826481	826616	135	0.437037037037037
2460	Sc_chr04	826616	827070	454	0.354625550660793
2461	Sc_chr04	827070	827431	361	0.3490304709141274
2462	Sc_chr04	827431	827733	302	0.3642384105960265
2463	Sc_chr04	827733	827983	250	0.38799999999999996
2464	Sc_chr04	827983	828010	27	0.3703703703703704
2465	Sc_chr04	828010	828373	363	0.3884297520661157
2466	Sc_chr04	828373	828523	150	0.38666666666666666
2467	Sc_chr04	828523	828621	98	0.37755102040816324
2468	Sc_chr04	828621	828739	118	0.4067796610169491
2469	Sc_chr04	828739	828975	236	0.3686440677966102
2470	Sc_chr04	828975	829083	108	0.3055555555555556
2471	Sc_chr04	829083	829466	383	0.34986945169712796
2472	Sc_chr04	829466	829731	265	0.30943396226415093
2473	Sc_chr04	829731	829782	51	0.3921568627450981
2474	Sc_chr04	829782	830773	991	0.3360242179616549
2475	Sc_chr04	830773	831194	421	0.3420427553444181
2476	Sc_chr04	831194	831365	171	0.3742690058479532
2477	Sc_chr04	831365	832204	839	0.3432657926102503
2478	Sc_chr04	832204	832217	13	0.5384615384615384
2479	Sc_chr04	832217	832386	169	0.49112426035502954
2480	Sc_chr04	832386	832566	180	0.33888888888888885
2481	Sc_chr04	832566	832601	35	0.34285714285714286
2482	Sc_chr04	832601	833174	573	0.3472949389179756
2483	Sc_chr04	833174	833383	209	0.3827751196172249
2484	Sc_chr04	833383	833774	391	0.3631713554987212
2485	Sc_chr04	833774	834290	516	0.4302325581395349
2486	Sc_chr04	834290	834958	668	0.4221556886227545
2487	Sc_chr04	834958	835086	128	0.3515625
2488	Sc_chr04	835086	835120	34	0.5
2489	Sc_chr04	835120	835192	72	0.41666666666666663
2490	Sc_chr04	835192	835276	84	0.40476190476190477
2491	Sc_chr04	835276	835381	105	0.4666666666666666
2492	Sc_chr04	835381	835674	293	0.44368600682593856
2493	Sc_chr04	835674	836218	544	0.4724264705882353
2494	Sc_chr04	836218	836620	402	0.44527363184079605
2495	Sc_chr04	836620	836767	147	0.5782312925170068
2496	Sc_chr04	836767	836830	63	0.42857142857142855
2497	Sc_chr04	836830	837004	174	0.5229885057471264
2498	Sc_chr04	837004	837247	243	0.45267489711934156
2499	Sc_chr04	837247	837281	34	0.411764705882353
2500	Sc_chr04	837281	837699	418	0.4665071770334928
2501	Sc_chr04	837699	838032	333	0.46846846846846846
2502	Sc_chr04	838032	838540	508	0.31496062992125984
2503	Sc_chr04	838540	838659	119	0.42857142857142855
2504	Sc_chr04	838659	839017	358	0.41899441340782123
2505	Sc_chr04	839017	839065	48	0.47916666666666663
2506	Sc_chr04	839065	839685	620	0.3758064516129032
2507	Sc_chr04	839685	839745	60	0.33333333333333337
2508	Sc_chr04	839745	839925	180	0.3055555555555556
2509	Sc_chr04	839925	840855	930	0.36451612903225805
2510	Sc_chr04	840855	840903	48	0.35416666666666663
2511	Sc_chr04	840903	841103	200	0.42
2512	Sc_chr04	841103	841351	248	0.38306451612903225
2513	Sc_chr04	841351	842359	1008	0.38888888888888884
2514	Sc_chr04	842359	842513	154	0.42857142857142855
2515	Sc_chr04	842513	842673	160	0.475
2516	Sc_chr04	842673	843135	462	0.3896103896103896
2517	Sc_chr04	843135	843660	525	0.36
2518	Sc_chr04	843660	843819	159	0.4025157232704402
2519	Sc_chr04	843819	844499	680	0.4411764705882353
2520	Sc_chr04	844499	845346	847	0.39669421487603307
2521	Sc_chr04	845346	845590	244	0.3319672131147541
2522	Sc_chr04	845590	845764	174	0.3620689655172413
2523	Sc_chr04	845764	846250	486	0.31893004115226337
2524	Sc_chr04	846250	846330	80	0.3875
2525	Sc_chr04	846330	846522	192	0.35416666666666663
2526	Sc_chr04	846522	846916	394	0.3350253807106599
2527	Sc_chr04	846916	847813	897	0.3656633221850613
2528	Sc_chr04	847813	849112	1299	0.3710546574287914
2529	Sc_chr04	849112	849574	462	0.36363636363636365
2530	Sc_chr04	849574	849756	182	0.3791208791208791
2531	Sc_chr04	849756	849977	221	0.3846153846153846
2532	Sc_chr04	849977	850472	495	0.3474747474747475
2533	Sc_chr04	850472	850854	382	0.36387434554973824
2534	Sc_chr04	850854	850969	115	0.45217391304347826
2535	Sc_chr04	850969	851512	543	0.3517495395948435
2536	Sc_chr04	851512	851891	379	0.36939313984168864
2537	Sc_chr04	851891	851908	17	0.4705882352941177
2538	Sc_chr04	851908	851923	15	0.26666666666666666
2539	Sc_chr04	851923	852103	180	0.36666666666666664
2540	Sc_chr04	852103	852107	4	0.5
2541	Sc_chr04	852107	852187	80	0.4
2542	Sc_chr04	852187	853041	854	0.3372365339578455
2543	Sc_chr04	853041	853458	417	0.38848920863309355
2544	Sc_chr04	853458	853484	26	0.4615384615384615
2545	Sc_chr04	853484	853665	181	0.3259668508287293
2546	Sc_chr04	853665	853864	199	0.3668341708542714
2547	Sc_chr04	853864	854143	279	0.33333333333333337
2548	Sc_chr04	854143	854655	512	0.330078125
2549	Sc_chr04	854655	855065	410	0.34146341463414637
2550	Sc_chr04	855065	855153	88	0.3181818181818182
2551	Sc_chr04	855153	855183	30	0.33333333333333337
2552	Sc_chr04	855183	855363	180	0.35
2553	Sc_chr04	855363	855393	30	0.36666666666666664
2554	Sc_chr04	855393	855488	95	0.368421052631579
2555	Sc_chr04	855488	855635	147	0.35374149659863946
2556	Sc_chr04	855635	855768	133	0.4135338345864662
2557	Sc_chr04	855768	855909	141	0.4184397163120568
2558	Sc_chr04	855909	855932	23	0.391304347826087
2559	Sc_chr04	855932	855953	21	0.4761904761904762
2560	Sc_chr04	855953	856026	73	0.5205479452054794
2561	Sc_chr04	856026	856265	239	0.401673640167364
2562	Sc_chr04	856265	856485	220	0.4181818181818182
2563	Sc_chr04	856485	856990	505	0.3603960396039604
2564	Sc_chr04	856990	857001	11	0.36363636363636365
2565	Sc_chr04	857001	857176	175	0.3657142857142857
2566	Sc_chr04	857176	857984	808	0.37623762376237624
2567	Sc_chr04	857984	858158	174	0.33333333333333337
2568	Sc_chr04	858158	858721	563	0.4369449378330373
2569	Sc_chr04	858721	858813	92	0.391304347826087
2570	Sc_chr04	858813	858972	159	0.44025157232704404
2571	Sc_chr04	858972	859051	79	0.45569620253164556
2572	Sc_chr04	859051	859235	184	0.42391304347826086
2573	Sc_chr04	859235	859243	8	0.5
2574	Sc_chr04	859243	859419	176	0.3806818181818182
2575	Sc_chr04	859419	859438	19	0.4210526315789474
2576	Sc_chr04	859438	859510	72	0.41666666666666663
2577	Sc_chr04	859510	859816	306	0.35947712418300654
2578	Sc_chr04	859816	860890	1074	0.3733705772811918
2579	Sc_chr04	860890	861016	126	0.3412698412698413
2580	Sc_chr04	861016	861021	5	0.6
2581	Sc_chr04	861021	861280	259	0.4324324324324324
2582	Sc_chr04	861280	861616	336	0.38095238095238093
2583	Sc_chr04	861616	861854	238	0.3403361344537815
2584	Sc_chr04	861854	862080	226	0.29646017699115046
2585	Sc_chr04	862080	862254	174	0.339080459770115
2586	Sc_chr04	862254	862269	15	0.26666666666666666
2587	Sc_chr04	862269	863189	920	0.3630434782608695
2588	Sc_chr04	863189	863637	448	0.3191964285714286
2589	Sc_chr04	863637	864152	515	0.39223300970873787
2590	Sc_chr04	864152	865091	939	0.36421725239616615
2591	Sc_chr04	865091	865658	567	0.4162257495590829
2592	Sc_chr04	865658	865927	269	0.38661710037174724
2593	Sc_chr04	865927	866020	93	0.4516129032258065
2594	Sc_chr04	866020	866770	750	0.43866666666666665
2595	Sc_chr04	866770	867041	271	0.5571955719557196
2596	Sc_chr04	867041	867110	69	0.6231884057971014
2597	Sc_chr04	867110	867158	48	0.375
2598	Sc_chr04	867158	867604	446	0.47982062780269064
2599	Sc_chr04	867604	868236	632	0.44303797468354433
2600	Sc_chr04	868236	868400	164	0.4573170731707317
2601	Sc_chr04	868400	868565	165	0.40606060606060607
2602	Sc_chr04	868565	868604	39	0.358974358974359
2603	Sc_chr04	868604	868793	189	0.37566137566137564
2604	Sc_chr04	868793	868827	34	0.411764705882353
2605	Sc_chr04	868827	869235	408	0.4044117647058823
2606	Sc_chr04	869235	869333	98	0.35714285714285715
2607	Sc_chr04	869333	869344	11	0.36363636363636365
2608	Sc_chr04	869344	869991	647	0.357032457496136
2609	Sc_chr04	869991	870305	314	0.3853503184713376
2610	Sc_chr04	870305	870491	186	0.3655913978494624
2611	Sc_chr04	870491	871412	921	0.3680781758957654
2612	Sc_chr04	871412	871642	230	0.28695652173913044
2613	Sc_chr04	871642	871968	326	0.30368098159509205
2614	Sc_chr04	871968	872201	233	0.32618025751072965
2615	Sc_chr04	872201	872537	336	0.4732142857142857
2616	Sc_chr04	872537	872555	18	0.4444444444444444
2617	Sc_chr04	872555	872974	419	0.3436754176610979
2618	Sc_chr04	872974	873341	367	0.3433242506811989
2619	Sc_chr04	873341	873465	124	0.4032258064516129
2620	Sc_chr04	873465	873508	43	0.4418604651162791
2621	Sc_chr04	873508	873672	164	0.3719512195121951
2622	Sc_chr04	873672	873742	70	0.35714285714285715
2623	Sc_chr04	873742	874057	315	0.3682539682539682
2624	Sc_chr04	874057	874305	248	0.3790322580645162
2625	Sc_chr04	874305	874824	519	0.39306358381502887
2626	Sc_chr04	874824	874890	66	0.3484848484848485
2627	Sc_chr04	874890	874908	18	0.2777777777777778
2628	Sc_chr04	874908	874944	36	0.33333333333333337
2629	Sc_chr04	874944	875080	136	0.39705882352941174
2630	Sc_chr04	875080	875451	371	0.40700808625336926
2631	Sc_chr04	875451	875467	16	0.5
2632	Sc_chr04	875467	875695	228	0.3991228070175438
2633	Sc_chr04	875695	875779	84	0.35714285714285715
2634	Sc_chr04	875779	875828	49	0.326530612244898
2635	Sc_chr04	875828	875991	163	0.2883435582822086
2636	Sc_chr04	875991	876572	581	0.3373493975903614
2637	Sc_chr04	876572	877216	644	0.35403726708074534
2638	Sc_chr04	877216	877223	7	0.42857142857142855
2639	Sc_chr04	877223	877424	201	0.3034825870646766
2640	Sc_chr04	877424	877595	171	0.30994152046783624
2641	Sc_chr04	877595	878484	889	0.2958380202474691
2642	Sc_chr04	878484	878655	171	0.30994152046783624
2643	Sc_chr04	878655	878856	201	0.3034825870646766
2644	Sc_chr04	878856	878863	7	0.42857142857142855
2645	Sc_chr04	878863	880300	1437	0.3437717466945024
2646	Sc_chr04	880300	880384	84	0.34523809523809523
2647	Sc_chr04	880384	880520	136	0.39705882352941174
2648	Sc_chr04	880520	880535	15	0.6
2649	Sc_chr04	880535	880915	380	0.42368421052631583
2650	Sc_chr04	880915	881132	217	0.4009216589861751
2651	Sc_chr04	881132	881148	16	0.375
2652	Sc_chr04	881148	881234	86	0.37209302325581395
2653	Sc_chr04	881234	881393	159	0.41509433962264153
2654	Sc_chr04	881393	882280	887	0.39571589627959414
2655	Sc_chr04	882280	882514	234	0.37606837606837606
2656	Sc_chr04	882514	882869	355	0.4028169014084507
2657	Sc_chr04	882869	883291	422	0.3696682464454976
2658	Sc_chr04	883291	883833	542	0.4446494464944649
2659	Sc_chr04	883833	884068	235	0.32340425531914896
2660	Sc_chr04	884068	884798	730	0.34657534246575344
2661	Sc_chr04	884798	885086	288	0.41666666666666663
2662	Sc_chr04	885086	885206	120	0.3
2663	Sc_chr04	885206	885668	462	0.3722943722943723
2664	Sc_chr04	885668	885762	94	0.35106382978723405
2665	Sc_chr04	885762	886100	338	0.35798816568047337
2666	Sc_chr04	886100	886409	309	0.37540453074433655
2667	Sc_chr04	886409	887731	1322	0.35627836611195157
2668	Sc_chr04	887731	888026	295	0.41355932203389834
2669	Sc_chr04	888026	888091	65	0.4153846153846154
2670	Sc_chr04	888091	888382	291	0.38144329896907214
2671	Sc_chr04	888382	888872	490	0.4102040816326531
2672	Sc_chr04	888872	888893	21	0.4761904761904762
2673	Sc_chr04	888893	888902	9	0.6666666666666667
2674	Sc_chr04	888902	889012	110	0.2545454545454545
2675	Sc_chr04	889012	889300	288	0.42361111111111116
2676	Sc_chr04	889300	889412	112	0.42857142857142855
2677	Sc_chr04	889412	889501	89	0.43820224719101125
2678	Sc_chr04	889501	890097	596	0.3859060402684564
2679	Sc_chr04	890097	890509	412	0.44417475728155337
2680	Sc_chr04	890509	891541	1032	0.4331395348837209
2681	Sc_chr04	891541	891945	404	0.443069306930693
2682	Sc_chr04	891945	892004	59	0.423728813559322
2683	Sc_chr04	892004	892033	29	0.20689655172413793
2684	Sc_chr04	892033	892295	262	0.37404580152671757
2685	Sc_chr04	892295	893124	829	0.3655006031363088
2686	Sc_chr04	893124	893256	132	0.4318181818181818
2687	Sc_chr04	893256	893604	348	0.4396551724137931
2688	Sc_chr04	893604	893677	73	0.4794520547945206
2689	Sc_chr04	893677	893849	172	0.4476744186046512
2690	Sc_chr04	893849	894039	190	0.3894736842105263
2691	Sc_chr04	894039	894645	606	0.48679867986798675
2692	Sc_chr04	894645	894700	55	0.32727272727272727
2693	Sc_chr04	894700	895234	534	0.3202247191011236
2694	Sc_chr04	895234	895404	170	0.4
2695	Sc_chr04	895404	895474	70	0.44285714285714284
2696	Sc_chr04	895474	895790	316	0.41139240506329117
2697	Sc_chr04	895790	895941	151	0.33774834437086093
2698	Sc_chr04	895941	896108	167	0.40718562874251496
2699	Sc_chr04	896108	896534	426	0.352112676056338
2700	Sc_chr04	896534	896558	24	0.45833333333333337
2701	Sc_chr04	896558	896637	79	0.3544303797468354
2702	Sc_chr04	896637	896957	320	0.375
2703	Sc_chr04	896957	897089	132	0.3939393939393939
2704	Sc_chr04	897089	897436	347	0.35158501440922185
2705	Sc_chr04	897436	897441	5	0.4
2706	Sc_chr04	897441	897860	419	0.30548926014319805
2707	Sc_chr04	897860	897949	89	0.39325842696629215
2708	Sc_chr04	897949	898016	67	0.23880597014925375
2709	Sc_chr04	898016	898234	218	0.34403669724770647
2710	Sc_chr04	898234	898561	327	0.33944954128440363
2711	Sc_chr04	898561	898643	82	0.3170731707317073
2712	Sc_chr04	898643	899137	494	0.38663967611336036
2713	Sc_chr04	899137	899355	218	0.3073394495412844
2714	Sc_chr04	899355	899791	436	0.29357798165137616
2715	Sc_chr04	899791	899932	141	0.36170212765957444
2716	Sc_chr04	899932	899990	58	0.32758620689655177
2717	Sc_chr04	899990	900004	14	0.21428571428571427
2718	Sc_chr04	900004	900762	758	0.37467018469656993
2719	Sc_chr04	900762	900801	39	0.48717948717948717
2720	Sc_chr04	900801	900908	107	0.34579439252336447
2721	Sc_chr04	900908	901018	110	0.40909090909090906
2722	Sc_chr04	901018	901356	338	0.3994082840236686
2723	Sc_chr04	901356	901637	281	0.3736654804270463
2724	Sc_chr04	901637	902314	677	0.3633677991137371
2725	Sc_chr04	902314	902576	262	0.37404580152671757
2726	Sc_chr04	902576	903005	429	0.36363636363636365
2727	Sc_chr04	903005	903062	57	0.3508771929824562
2728	Sc_chr04	903062	903185	123	0.38211382113821135
2729	Sc_chr04	903185	903356	171	0.3508771929824562
2730	Sc_chr04	903356	903440	84	0.4880952380952381
2731	Sc_chr04	903440	904257	817	0.3512851897184822
2732	Sc_chr04	904257	904793	536	0.3638059701492537
2733	Sc_chr04	904793	905033	240	0.39583333333333337
2734	Sc_chr04	905033	905189	156	0.3269230769230769
2735	Sc_chr04	905189	905498	309	0.32362459546925565
2736	Sc_chr04	905498	906077	579	0.34369602763385143
2737	Sc_chr04	906077	906503	426	0.352112676056338
2738	Sc_chr04	906503	907756	1253	0.3822825219473264
2739	Sc_chr04	907756	908016	260	0.4
2740	Sc_chr04	908016	908062	46	0.32608695652173914
2741	Sc_chr04	908062	908590	528	0.36363636363636365
2742	Sc_chr04	908590	908682	92	0.45652173913043476
2743	Sc_chr04	908682	908929	247	0.3441295546558705
2744	Sc_chr04	908929	909053	124	0.3870967741935484
2745	Sc_chr04	909053	909283	230	0.3956521739130435
2746	Sc_chr04	909283	910718	1435	0.3693379790940767
2747	Sc_chr04	910718	910950	232	0.35775862068965514
2748	Sc_chr04	910950	912959	2009	0.38725734196117473
2749	Sc_chr04	912959	913169	210	0.39047619047619053
2750	Sc_chr04	913169	913550	381	0.3700787401574803
2751	Sc_chr04	913550	913628	78	0.34615384615384615
2752	Sc_chr04	913628	913686	58	0.39655172413793105
2753	Sc_chr04	913686	913702	16	0.5
2754	Sc_chr04	913702	913730	28	0.4642857142857143
2755	Sc_chr04	913730	914397	667	0.29535232383808097
2756	Sc_chr04	914397	914828	431	0.37354988399071926
2757	Sc_chr04	914828	915318	490	0.42244897959183675
2758	Sc_chr04	915318	915584	266	0.31954887218045114
2759	Sc_chr04	915584	915928	344	0.42441860465116277
2760	Sc_chr04	915928	916252	324	0.3395061728395062
2761	Sc_chr04	916252	916609	357	0.41456582633053224
2762	Sc_chr04	916609	916703	94	0.3829787234042554
2763	Sc_chr04	916703	916909	206	0.4223300970873787
2764	Sc_chr04	916909	916922	13	0.4615384615384615
2765	Sc_chr04	916922	916984	62	0.43548387096774194
2766	Sc_chr04	916984	918201	1217	0.36483155299917835
2767	Sc_chr04	918201	918583	382	0.40575916230366493
2768	Sc_chr04	918583	918614	31	0.41935483870967744
2769	Sc_chr04	918614	919762	1148	0.36846689895470386
2770	Sc_chr04	919762	919970	208	0.3990384615384615
2771	Sc_chr04	919970	919997	27	0.4074074074074074
2772	Sc_chr04	919997	920086	89	0.34831460674157305
2773	Sc_chr04	920086	921182	1096	0.3686131386861314
2774	Sc_chr04	921182	922281	1099	0.32666060054595086
2775	Sc_chr04	922281	922442	161	0.34161490683229817
2776	Sc_chr04	922442	922559	117	0.358974358974359
2777	Sc_chr04	922559	923799	1240	0.3709677419354838
2778	Sc_chr04	923799	924131	332	0.3524096385542169
2779	Sc_chr04	924131	924501	370	0.3810810810810811
2780	Sc_chr04	924501	924815	314	0.33439490445859876
2781	Sc_chr04	924815	925525	710	0.4028169014084507
2782	Sc_chr04	925525	926475	950	0.43473684210526314
2783	Sc_chr04	926475	926599	124	0.43548387096774194
2784	Sc_chr04	926599	926694	95	0.49473684210526314
2785	Sc_chr04	926694	926796	102	0.4901960784313726
2786	Sc_chr04	926796	926831	35	0.5142857142857143
2787	Sc_chr04	926831	926873	42	0.5
2788	Sc_chr04	926873	927168	295	0.4983050847457627
2789	Sc_chr04	927168	928440	1272	0.46698113207547165
2790	Sc_chr04	928440	928506	66	0.5151515151515151
2791	Sc_chr04	928506	928520	14	0.42857142857142855
2792	Sc_chr04	928520	930154	1634	0.3843329253365973
2793	Sc_chr04	930154	930201	47	0.36170212765957444
2794	Sc_chr04	930201	930447	246	0.3617886178861789
2795	Sc_chr04	930447	931135	688	0.38662790697674415
2796	Sc_chr04	931135	931271	136	0.44852941176470584
2797	Sc_chr04	931271	931349	78	0.5128205128205129
2798	Sc_chr04	931349	931652	303	0.47194719471947194
2799	Sc_chr04	931652	931749	97	0.4536082474226804
2800	Sc_chr04	931749	931809	60	0.41666666666666663
2801	Sc_chr04	931809	931886	77	0.4935064935064935
2802	Sc_chr04	931886	932024	138	0.427536231884058
2803	Sc_chr04	932024	932031	7	0.42857142857142855
2804	Sc_chr04	932031	932097	66	0.48484848484848486
2805	Sc_chr04	932097	932917	820	0.45487804878048776
2806	Sc_chr04	932917	933116	199	0.38190954773869346
2807	Sc_chr04	933116	933813	697	0.34720229555236726
2808	Sc_chr04	933813	934430	617	0.3192868719611021
2809	Sc_chr04	934430	935230	800	0.33125
2810	Sc_chr04	935230	935316	86	0.4069767441860465
2811	Sc_chr04	935316	935698	382	0.3769633507853403
2812	Sc_chr04	935698	936098	400	0.4025
2813	Sc_chr04	936098	936147	49	0.2653061224489796
2814	Sc_chr04	936147	936642	495	0.37777777777777777
2815	Sc_chr04	936642	937982	1340	0.3753731343283582
2816	Sc_chr04	937982	938592	610	0.3918032786885246
2817	Sc_chr04	938592	939461	869	0.3912543153049482
2818	Sc_chr04	939461	939529	68	0.38235294117647056
2819	Sc_chr04	939529	939696	167	0.3832335329341317
2820	Sc_chr04	939696	940206	510	0.3941176470588236
2821	Sc_chr04	940206	940251	45	0.2888888888888889
2822	Sc_chr04	940251	940709	458	0.3580786026200873
2823	Sc_chr04	940709	940770	61	0.4426229508196721
2824	Sc_chr04	940770	941303	533	0.399624765478424
2825	Sc_chr04	941303	941825	522	0.38888888888888884
2826	Sc_chr04	941825	942159	334	0.41317365269461076
2827	Sc_chr04	942159	942246	87	0.3793103448275862
2828	Sc_chr04	942246	942567	321	0.38006230529595014
2829	Sc_chr04	942567	943080	513	0.3937621832358674
2830	Sc_chr04	943080	943875	795	0.36477987421383645
2831	Sc_chr04	943875	943882	7	0.42857142857142855
2832	Sc_chr04	943882	944251	369	0.3631436314363144
2833	Sc_chr04	944251	945345	1094	0.3601462522851919
2834	Sc_chr04	945345	945552	207	0.2995169082125604
2835	Sc_chr04	945552	946128	576	0.3315972222222222
2836	Sc_chr04	946128	946371	243	0.3786008230452675
2837	Sc_chr04	946371	946851	480	0.36875
2838	Sc_chr04	946851	946976	125	0.29600000000000004
2839	Sc_chr04	946976	947428	452	0.39823008849557523
2840	Sc_chr04	947428	947637	209	0.45454545454545453
2841	Sc_chr04	947637	947793	156	0.3717948717948718
2842	Sc_chr04	947793	947910	117	0.452991452991453
2843	Sc_chr04	947910	948320	410	0.3804878048780488
2844	Sc_chr04	948320	948475	155	0.3354838709677419
2845	Sc_chr04	948475	948600	125	0.312
2846	Sc_chr04	948600	948808	208	0.4182692307692308
2847	Sc_chr04	948808	948975	167	0.34131736526946105
2848	Sc_chr04	948975	949959	984	0.3861788617886179
2849	Sc_chr04	949959	950165	206	0.3737864077669903
2850	Sc_chr04	950165	950389	224	0.36160714285714285
2851	Sc_chr04	950389	950792	403	0.37965260545905705
2852	Sc_chr04	950792	951085	293	0.4129692832764505
2853	Sc_chr04	951085	951177	92	0.45652173913043476
2854	Sc_chr04	951177	951312	135	0.35555555555555557
2855	Sc_chr04	951312	951815	503	0.40556660039761433
2856	Sc_chr04	951815	951927	112	0.32142857142857145
2857	Sc_chr04	951927	952078	151	0.3841059602649007
2858	Sc_chr04	952078	952261	183	0.3879781420765028
2859	Sc_chr04	952261	953127	866	0.3325635103926097
2860	Sc_chr04	953127	953153	26	0.3846153846153846
2861	Sc_chr04	953153	953782	629	0.3990461049284578
2862	Sc_chr04	953782	954659	877	0.37856328392246297
2863	Sc_chr04	954659	954894	235	0.46808510638297873
2864	Sc_chr04	954894	955100	206	0.41262135922330095
2865	Sc_chr04	955100	955362	262	0.4770992366412214
2866	Sc_chr04	955362	956273	911	0.3809001097694841
2867	Sc_chr04	956273	956515	242	0.3677685950413223
2868	Sc_chr04	956515	956882	367	0.4087193460490463
2869	Sc_chr04	956882	957470	588	0.39285714285714285
2870	Sc_chr04	957470	957613	143	0.3146853146853147
2871	Sc_chr04	957613	957882	269	0.3048327137546469
2872	Sc_chr04	957882	958861	979	0.36772216547497444
2873	Sc_chr04	958861	958978	117	0.3418803418803419
2874	Sc_chr04	958978	959339	361	0.332409972299169
2875	Sc_chr04	959339	959385	46	0.30434782608695654
2876	Sc_chr04	959385	959438	53	0.339622641509434
2877	Sc_chr04	959438	959463	25	0.32
2878	Sc_chr04	959463	959645	182	0.3791208791208791
2879	Sc_chr04	959645	960016	371	0.3746630727762803
2880	Sc_chr04	960016	960646	630	0.37936507936507935
2881	Sc_chr04	960646	960991	345	0.36231884057971014
2882	Sc_chr04	960991	961104	113	0.3893805309734513
2883	Sc_chr04	961104	961222	118	0.364406779661017
2884	Sc_chr04	961222	961285	63	0.42857142857142855
2885	Sc_chr04	961285	961903	618	0.3300970873786408
2886	Sc_chr04	961903	962371	468	0.39957264957264954
2887	Sc_chr04	962371	962612	241	0.4066390041493776
2888	Sc_chr04	962612	962892	280	0.39642857142857146
2889	Sc_chr04	962892	963253	361	0.3545706371191136
2890	Sc_chr04	963253	963420	167	0.30538922155688625
2891	Sc_chr04	963420	964236	816	0.38357843137254904
2892	Sc_chr04	964236	964300	64	0.3125
2893	Sc_chr04	964300	964483	183	0.36612021857923494
2894	Sc_chr04	964483	964555	72	0.33333333333333337
2895	Sc_chr04	964555	965211	656	0.3246951219512195
2896	Sc_chr04	965211	965514	303	0.36633663366336633
2897	Sc_chr04	965514	966101	587	0.3526405451448041
2898	Sc_chr04	966101	966135	34	0.411764705882353
2899	Sc_chr04	966135	966418	283	0.2968197879858657
2900	Sc_chr04	966418	966748	330	0.37878787878787873
2901	Sc_chr04	966748	967263	515	0.35922330097087374
2902	Sc_chr04	967263	967728	465	0.33333333333333337
2903	Sc_chr04	967728	968644	916	0.3941048034934498
2904	Sc_chr04	968644	968922	278	0.44964028776978415
2905	Sc_chr04	968922	968971	49	0.3877551020408163
2906	Sc_chr04	968971	969095	124	0.4112903225806452
2907	Sc_chr04	969095	969310	215	0.42790697674418604
2908	Sc_chr04	969310	971217	1907	0.36759307813319353
2909	Sc_chr04	971217	971380	163	0.38036809815950917
2910	Sc_chr04	971380	971514	134	0.3283582089552239
2911	Sc_chr04	971514	971995	481	0.32432432432432434
2912	Sc_chr04	971995	972070	75	0.38666666666666666
2913	Sc_chr04	972070	972180	110	0.32727272727272727
2914	Sc_chr04	972180	972296	116	0.35344827586206895
2915	Sc_chr04	972296	973189	893	0.40201567749160133
2916	Sc_chr04	973189	973261	72	0.4027777777777778
2917	Sc_chr04	973261	973343	82	0.3780487804878049
2918	Sc_chr04	973343	973459	116	0.42241379310344823
2919	Sc_chr04	973459	973701	242	0.37603305785123964
2920	Sc_chr04	973701	973723	22	0.40909090909090906
2921	Sc_chr04	973723	973817	94	0.48936170212765956
2922	Sc_chr04	973817	973978	161	0.38509316770186336
2923	Sc_chr04	973978	974136	158	0.379746835443038
2924	Sc_chr04	974136	974585	449	0.334075723830735
2925	Sc_chr04	974585	974602	17	0.411764705882353
2926	Sc_chr04	974602	974673	71	0.43661971830985913
2927	Sc_chr04	974673	974750	77	0.2727272727272727
2928	Sc_chr04	974750	975525	775	0.3406451612903226
2929	Sc_chr04	975525	976481	956	0.37029288702928875
2930	Sc_chr04	976481	976691	210	0.3761904761904762
2931	Sc_chr04	976691	976871	180	0.4666666666666666
2932	Sc_chr04	976871	977743	872	0.4048165137614679
2933	Sc_chr04	977743	978016	273	0.4249084249084249
2934	Sc_chr04	978016	978616	600	0.4083333333333334
2935	Sc_chr04	978616	978635	19	0.5263157894736842
2936	Sc_chr04	978635	978722	87	0.3448275862068966
2937	Sc_chr04	978722	978795	73	0.3561643835616438
2938	Sc_chr04	978795	979776	981	0.34964322120285424
2939	Sc_chr04	979776	980857	1081	0.3496762257169288
2940	Sc_chr04	980857	981318	461	0.3318872017353579
2941	Sc_chr04	981318	981551	233	0.32618025751072965
2942	Sc_chr04	981551	981887	336	0.4732142857142857
2943	Sc_chr04	981887	982324	437	0.3524027459954233
2944	Sc_chr04	982324	982691	367	0.3433242506811989
2945	Sc_chr04	982691	982815	124	0.4032258064516129
2946	Sc_chr04	982815	982858	43	0.4418604651162791
2947	Sc_chr04	982858	983022	164	0.3719512195121951
2948	Sc_chr04	983022	983092	70	0.35714285714285715
2949	Sc_chr04	983092	983407	315	0.36507936507936506
2950	Sc_chr04	983407	983655	248	0.3790322580645162
2951	Sc_chr04	983655	984174	519	0.3872832369942196
2952	Sc_chr04	984174	984240	66	0.3484848484848485
2953	Sc_chr04	984240	984258	18	0.2777777777777778
2954	Sc_chr04	984258	984294	36	0.33333333333333337
2955	Sc_chr04	984294	984430	136	0.39705882352941174
2956	Sc_chr04	984430	984801	371	0.40970350404312667
2957	Sc_chr04	984801	984817	16	0.5
2958	Sc_chr04	984817	985045	228	0.3859649122807018
2959	Sc_chr04	985045	985129	84	0.35714285714285715
2960	Sc_chr04	985129	985178	49	0.326530612244898
2961	Sc_chr04	985178	985341	163	0.2883435582822086
2962	Sc_chr04	985341	985922	581	0.3356282271944922
2963	Sc_chr04	985922	986566	644	0.3447204968944099
2964	Sc_chr04	986566	986573	7	0.42857142857142855
2965	Sc_chr04	986573	986774	201	0.3034825870646766
2966	Sc_chr04	986774	986945	171	0.30994152046783624
2967	Sc_chr04	986945	987331	386	0.2823834196891192
2968	Sc_chr04	987331	987502	171	0.30994152046783624
2969	Sc_chr04	987502	988722	1220	0.33524590163934426
2970	Sc_chr04	988722	988806	84	0.34523809523809523
2971	Sc_chr04	988806	988942	136	0.4044117647058823
2972	Sc_chr04	988942	988957	15	0.6
2973	Sc_chr04	988957	989337	380	0.4210526315789474
2974	Sc_chr04	989337	989554	217	0.4147465437788018
2975	Sc_chr04	989554	989570	16	0.375
2976	Sc_chr04	989570	989656	86	0.37209302325581395
2977	Sc_chr04	989656	989815	159	0.40880503144654085
2978	Sc_chr04	989815	990936	1121	0.39250669045495096
2979	Sc_chr04	990936	991291	355	0.4
2980	Sc_chr04	991291	991713	422	0.3696682464454976
2981	Sc_chr04	991713	992255	542	0.45018450184501846
2982	Sc_chr04	992255	992490	235	0.32765957446808514
2983	Sc_chr04	992490	992922	432	0.3472222222222222
2984	Sc_chr04	992922	993692	770	0.38051948051948054
2985	Sc_chr04	993692	994044	352	0.375
2986	Sc_chr04	994044	994268	224	0.3125
2987	Sc_chr04	994268	994519	251	0.398406374501992
2988	Sc_chr04	994519	994560	41	0.29268292682926833
2989	Sc_chr04	994560	994969	409	0.35696821515892424
2990	Sc_chr04	994969	995077	108	0.3425925925925926
2991	Sc_chr04	995077	995321	244	0.3319672131147541
2992	Sc_chr04	995321	995572	251	0.36254980079681276
2993	Sc_chr04	995572	996300	728	0.34752747252747257
2994	Sc_chr04	996300	996405	105	0.5047619047619047
2995	Sc_chr04	996405	996553	148	0.3918918918918919
2996	Sc_chr04	996553	996639	86	0.32558139534883723
2997	Sc_chr04	996639	996814	175	0.33714285714285713
2998	Sc_chr04	996814	996831	17	0.4705882352941177
2999	Sc_chr04	996831	996975	144	0.375
3000	Sc_chr04	996975	997597	622	0.3858520900321543
3001	Sc_chr04	997597	997818	221	0.411764705882353
3002	Sc_chr04	997818	998067	249	0.42971887550200805
3003	Sc_chr04	998067	998109	42	0.5
3004	Sc_chr04	998109	998171	62	0.46774193548387094
3005	Sc_chr04	998171	998256	85	0.4
3006	Sc_chr04	998256	998465	209	0.3875598086124402
3007	Sc_chr04	998465	998549	84	0.4404761904761905
3008	Sc_chr04	998549	999745	1196	0.37876254180602004
3009	Sc_chr04	999745	1000237	492	0.3780487804878049
3010	Sc_chr04	1000237	1000495	258	0.39922480620155043
3011	Sc_chr04	1000495	1000944	449	0.3830734966592428
3012	Sc_chr04	1000944	1001024	80	0.4625
3013	Sc_chr04	1001024	1001474	450	0.39111111111111113
3014	Sc_chr04	1001474	1001680	206	0.30097087378640774
3015	Sc_chr04	1001680	1002093	413	0.3898305084745763
3016	Sc_chr04	1002093	1002457	364	0.3324175824175824
3017	Sc_chr04	1002457	1002461	4	0.5
3018	Sc_chr04	1002461	1002542	81	0.3703703703703704
3019	Sc_chr04	1002542	1002796	254	0.4291338582677165
3020	Sc_chr04	1002796	1003314	518	0.444015444015444
3021	Sc_chr04	1003314	1003402	88	0.3522727272727273
3022	Sc_chr04	1003402	1003798	396	0.33333333333333337
3023	Sc_chr04	1003798	1004327	529	0.3856332703213611
3024	Sc_chr04	1004327	1004347	20	0.5
3025	Sc_chr04	1004347	1004594	247	0.4129554655870445
3026	Sc_chr04	1004594	1004747	153	0.3464052287581699
3027	Sc_chr04	1004747	1005247	500	0.374
3028	Sc_chr04	1005247	1005363	116	0.45689655172413796
3029	Sc_chr04	1005363	1006159	796	0.41331658291457285
3030	Sc_chr04	1006159	1006783	624	0.37980769230769235
3031	Sc_chr04	1006783	1006807	24	0.375
3032	Sc_chr04	1006807	1007272	465	0.3870967741935484
3033	Sc_chr04	1007272	1008128	856	0.3796728971962617
3034	Sc_chr04	1008128	1008221	93	0.41935483870967744
3035	Sc_chr04	1008221	1008296	75	0.4
3036	Sc_chr04	1008296	1009105	809	0.3559950556242274
3037	Sc_chr04	1009105	1009402	297	0.3973063973063973
3038	Sc_chr04	1009402	1009738	336	0.4107142857142857
3039	Sc_chr04	1009738	1010764	1026	0.3635477582846004
3040	Sc_chr04	1010764	1011592	828	0.4311594202898551
3041	Sc_chr04	1011592	1012078	486	0.4609053497942387
3042	Sc_chr04	1012078	1012295	217	0.3225806451612903
3043	Sc_chr04	1012295	1012299	4	0.5
3044	Sc_chr04	1012299	1012334	35	0.42857142857142855
3045	Sc_chr04	1012334	1012432	98	0.39795918367346933
3046	Sc_chr04	1012432	1012523	91	0.42857142857142855
3047	Sc_chr04	1012523	1012527	4	0.5
3048	Sc_chr04	1012527	1012588	61	0.39344262295081966
3049	Sc_chr04	1012588	1012706	118	0.3813559322033898
3050	Sc_chr04	1012706	1012901	195	0.35384615384615387
3051	Sc_chr04	1012901	1013625	724	0.34806629834254144
3052	Sc_chr04	1013625	1013914	289	0.42214532871972316
3053	Sc_chr04	1013914	1013995	81	0.49382716049382713
3054	Sc_chr04	1013995	1014163	168	0.48214285714285715
3055	Sc_chr04	1014163	1014536	373	0.3941018766756032
3056	Sc_chr04	1014536	1014924	388	0.3788659793814433
3057	Sc_chr04	1014924	1015076	152	0.4144736842105263
3058	Sc_chr04	1015076	1015370	294	0.41836734693877553
3059	Sc_chr04	1015370	1016289	919	0.383025027203482
3060	Sc_chr04	1016289	1016466	177	0.4293785310734463
3061	Sc_chr04	1016466	1016779	313	0.4057507987220448
3062	Sc_chr04	1016779	1017500	721	0.332871012482663
3063	Sc_chr04	1017500	1017882	382	0.28534031413612565
3064	Sc_chr04	1017882	1018164	282	0.326241134751773
3065	Sc_chr04	1018164	1019260	1096	0.3348540145985402
3066	Sc_chr04	1019260	1019533	273	0.3663003663003663
3067	Sc_chr04	1019533	1019621	88	0.38636363636363635
3068	Sc_chr04	1019621	1019652	31	0.29032258064516125
3069	Sc_chr04	1019652	1019972	320	0.353125
3070	Sc_chr04	1019972	1020836	864	0.35763888888888884
3071	Sc_chr04	1020836	1021264	428	0.40887850467289716
3072	Sc_chr04	1021264	1021574	310	0.3903225806451613
3073	Sc_chr04	1021574	1021657	83	0.40963855421686746
3074	Sc_chr04	1021657	1022974	1317	0.3659832953682612
3075	Sc_chr04	1022974	1023016	42	0.35714285714285715
3076	Sc_chr04	1023016	1023299	283	0.33215547703180215
3077	Sc_chr04	1023299	1023527	228	0.34210526315789475
3078	Sc_chr04	1023527	1023791	264	0.37121212121212127
3079	Sc_chr04	1023791	1024025	234	0.3846153846153846
3080	Sc_chr04	1024025	1024270	245	0.3877551020408163
3081	Sc_chr04	1024270	1024403	133	0.3383458646616541
3082	Sc_chr04	1024403	1024454	51	0.411764705882353
3083	Sc_chr04	1024454	1024772	318	0.38679245283018865
3084	Sc_chr04	1024772	1025056	284	0.3626760563380282
3085	Sc_chr04	1025056	1025397	341	0.36950146627565983
3086	Sc_chr04	1025397	1025555	158	0.3924050632911393
3087	Sc_chr04	1025555	1025608	53	0.3018867924528302
3088	Sc_chr04	1025608	1026105	497	0.38832997987927564
3089	Sc_chr04	1026105	1026679	574	0.3519163763066202
3090	Sc_chr04	1026679	1027153	474	0.3945147679324894
3091	Sc_chr04	1027153	1027239	86	0.32558139534883723
3092	Sc_chr04	1027239	1027292	53	0.32075471698113206
3093	Sc_chr04	1027292	1027461	169	0.3431952662721893
3094	Sc_chr04	1027461	1027543	82	0.32926829268292684
3095	Sc_chr04	1027543	1027649	106	0.339622641509434
3096	Sc_chr04	1027649	1027834	185	0.3675675675675676
3097	Sc_chr04	1027834	1027960	126	0.32539682539682535
3098	Sc_chr04	1027960	1028168	208	0.3317307692307692
3099	Sc_chr04	1028168	1028271	103	0.4563106796116505
3100	Sc_chr04	1028271	1028319	48	0.375
3101	Sc_chr04	1028319	1028515	196	0.3826530612244898
3102	Sc_chr04	1028515	1028542	27	0.2962962962962963
3103	Sc_chr04	1028542	1028616	74	0.3108108108108108
3104	Sc_chr04	1028616	1028849	233	0.38197424892703863
3105	Sc_chr04	1028849	1029546	697	0.3500717360114778
3106	Sc_chr04	1029546	1029628	82	0.25609756097560976
3107	Sc_chr04	1029628	1029888	260	0.34615384615384615
3108	Sc_chr04	1029888	1030021	133	0.3533834586466165
3109	Sc_chr04	1030021	1030591	570	0.3087719298245614
3110	Sc_chr04	1030591	1030662	71	0.5070422535211268
3111	Sc_chr04	1030662	1031028	366	0.42076502732240434
3112	Sc_chr04	1031028	1031271	243	0.3497942386831276
3113	Sc_chr04	1031271	1031644	373	0.35656836461126007
3114	Sc_chr04	1031644	1031845	201	0.34328358208955223
3115	Sc_chr04	1031845	1032085	240	0.3375
3116	Sc_chr04	1032085	1032097	12	0.41666666666666663
3117	Sc_chr04	1032097	1032852	755	0.36026490066225164
3118	Sc_chr04	1032852	1033097	245	0.36326530612244895
3119	Sc_chr04	1033097	1034145	1048	0.3320610687022901
3120	Sc_chr04	1034145	1034307	162	0.30864197530864196
3121	Sc_chr04	1034307	1034808	501	0.36726546906187624
3122	Sc_chr04	1034808	1034871	63	0.28571428571428575
3123	Sc_chr04	1034871	1035290	419	0.3269689737470167
3124	Sc_chr04	1035290	1035310	20	0.5
3125	Sc_chr04	1035310	1035469	159	0.3522012578616352
3126	Sc_chr04	1035469	1036273	804	0.35945273631840796
3127	Sc_chr04	1036273	1036432	159	0.40880503144654085
3128	Sc_chr04	1036432	1037253	821	0.4190012180267966
3129	Sc_chr04	1037253	1037325	72	0.33333333333333337
3130	Sc_chr04	1037325	1037719	394	0.36548223350253806
3131	Sc_chr04	1037719	1037725	6	0.5
3132	Sc_chr04	1037725	1037805	80	0.3125
3133	Sc_chr04	1037805	1038628	823	0.370595382746051
3134	Sc_chr04	1038628	1038971	343	0.34110787172011664
3135	Sc_chr04	1038971	1040360	1389	0.3491720662347012
3136	Sc_chr04	1040360	1040708	348	0.3735632183908046
3137	Sc_chr04	1040708	1040723	15	0.26666666666666666
3138	Sc_chr04	1040723	1040774	51	0.3921568627450981
3139	Sc_chr04	1040774	1040809	35	0.28571428571428575
3140	Sc_chr04	1040809	1041024	215	0.38139534883720927
3141	Sc_chr04	1041024	1041404	380	0.381578947368421
3142	Sc_chr04	1041404	1041668	264	0.4242424242424242
3143	Sc_chr04	1041668	1041956	288	0.38541666666666663
3144	Sc_chr04	1041956	1042172	216	0.36111111111111116
3145	Sc_chr04	1042172	1042237	65	0.35384615384615387
3146	Sc_chr04	1042237	1042291	54	0.2962962962962963
3147	Sc_chr04	1042291	1042793	502	0.4143426294820717
3148	Sc_chr04	1042793	1043456	663	0.35444947209653094
3149	Sc_chr04	1043456	1043507	51	0.3921568627450981
3150	Sc_chr04	1043507	1043557	50	0.38
3151	Sc_chr04	1043557	1043822	265	0.3962264150943396
3152	Sc_chr04	1043822	1043879	57	0.3859649122807018
3153	Sc_chr04	1043879	1043984	105	0.38095238095238093
3154	Sc_chr04	1043984	1044093	109	0.34862385321100914
3155	Sc_chr04	1044093	1044206	113	0.37168141592920356
3156	Sc_chr04	1044206	1044478	272	0.38602941176470584
3157	Sc_chr04	1044478	1045887	1409	0.3349893541518808
3158	Sc_chr04	1045887	1045894	7	0.5714285714285715
3159	Sc_chr04	1045894	1045955	61	0.42622950819672134
3160	Sc_chr04	1045955	1046089	134	0.3805970149253731
3161	Sc_chr04	1046089	1046103	14	0.35714285714285715
3162	Sc_chr04	1046103	1046382	279	0.36200716845878134
3163	Sc_chr04	1046382	1046679	297	0.3872053872053872
3164	Sc_chr04	1046679	1046850	171	0.38011695906432746
3165	Sc_chr04	1046850	1046876	26	0.23076923076923075
3166	Sc_chr04	1046876	1047396	520	0.4230769230769231
3167	Sc_chr04	1047396	1047459	63	0.28571428571428575
3168	Sc_chr04	1047459	1048089	630	0.38888888888888884
3169	Sc_chr04	1048089	1048212	123	0.4227642276422764
3170	Sc_chr04	1048212	1048277	65	0.5076923076923077
3171	Sc_chr04	1048277	1048514	237	0.4008438818565401
3172	Sc_chr04	1048514	1049357	843	0.43653618030842234
3173	Sc_chr04	1049357	1049756	399	0.3609022556390978
3174	Sc_chr04	1049756	1050090	334	0.34431137724550903
3175	Sc_chr04	1050090	1050388	298	0.40939597315436244
3176	Sc_chr04	1050388	1050650	262	0.4389312977099237
3177	Sc_chr04	1050650	1051363	713	0.4151472650771389
3178	Sc_chr04	1051363	1051685	322	0.4316770186335404
3179	Sc_chr04	1051685	1051845	160	0.43125
3180	Sc_chr04	1051845	1051865	20	0.35
3181	Sc_chr04	1051865	1052039	174	0.3793103448275862
3182	Sc_chr04	1052039	1052283	244	0.36885245901639346
3183	Sc_chr04	1052283	1052644	361	0.33518005540166207
3184	Sc_chr04	1052644	1052653	9	0.33333333333333337
3185	Sc_chr04	1052653	1053058	405	0.362962962962963
3186	Sc_chr04	1053058	1053654	596	0.3775167785234899
3187	Sc_chr04	1053654	1053752	98	0.3469387755102041
3188	Sc_chr04	1053752	1053851	99	0.37373737373737376
3189	Sc_chr04	1053851	1053899	48	0.25
3190	Sc_chr04	1053899	1055150	1251	0.36370903277378097
3191	Sc_chr04	1055150	1056912	1762	0.4438138479001135
3192	Sc_chr04	1056912	1057029	117	0.4444444444444444
3193	Sc_chr04	1057029	1058372	1343	0.344005956813105
3194	Sc_chr04	1058372	1059026	654	0.38990825688073394
3195	Sc_chr04	1059026	1059306	280	0.375
3196	Sc_chr04	1059306	1059457	151	0.39072847682119205
3197	Sc_chr04	1059457	1059644	187	0.3368983957219251
3198	Sc_chr04	1059644	1059854	210	0.3523809523809524
3199	Sc_chr04	1059854	1060382	528	0.36742424242424243
3200	Sc_chr04	1060382	1060434	52	0.34615384615384615
3201	Sc_chr04	1060434	1061033	599	0.3756260434056761
3202	Sc_chr04	1061033	1061302	269	0.3568773234200744
3203	Sc_chr04	1061302	1061668	366	0.3442622950819672
3204	Sc_chr04	1061668	1062068	400	0.37
3205	Sc_chr04	1062068	1062193	125	0.496
3206	Sc_chr04	1062193	1062209	16	0.4375
3207	Sc_chr04	1062209	1062487	278	0.36690647482014394
3208	Sc_chr04	1062487	1062508	21	0.33333333333333337
3209	Sc_chr04	1062508	1062521	13	0.6153846153846154
3210	Sc_chr04	1062521	1062749	228	0.4035087719298246
3211	Sc_chr04	1062749	1063193	444	0.35585585585585583
3212	Sc_chr04	1063193	1063269	76	0.34210526315789475
3213	Sc_chr04	1063269	1063527	258	0.3953488372093023
3214	Sc_chr04	1063527	1063726	199	0.4271356783919598
3215	Sc_chr04	1063726	1064188	462	0.40476190476190477
3216	Sc_chr04	1064188	1064539	351	0.3475783475783476
3217	Sc_chr04	1064539	1065084	545	0.37247706422018345
3218	Sc_chr04	1065084	1065343	259	0.3397683397683398
3219	Sc_chr04	1065343	1065675	332	0.29518072289156627
3220	Sc_chr04	1065675	1065685	10	0.6
3221	Sc_chr04	1065685	1065835	150	0.32
3222	Sc_chr04	1065835	1066149	314	0.3821656050955414
3223	Sc_chr04	1066149	1066406	257	0.3696498054474708
3224	Sc_chr04	1066406	1067182	776	0.39304123711340205
3225	Sc_chr04	1067182	1067402	220	0.40909090909090906
3226	Sc_chr04	1067402	1067832	430	0.34883720930232553
3227	Sc_chr04	1067832	1067838	6	0.33333333333333337
3228	Sc_chr04	1067838	1068035	197	0.32994923857868025
3229	Sc_chr04	1068035	1068492	457	0.33698030634573306
3230	Sc_chr04	1068492	1069600	1108	0.30054151624548736
3231	Sc_chr04	1069600	1069672	72	0.2638888888888889
3232	Sc_chr04	1069672	1070125	453	0.34216335540838855
3233	Sc_chr04	1070125	1070452	327	0.33027522935779813
3234	Sc_chr04	1070452	1070593	141	0.2765957446808511
3235	Sc_chr04	1070593	1070767	174	0.41954022988505746
3236	Sc_chr04	1070767	1071030	263	0.3840304182509506
3237	Sc_chr04	1071030	1071310	280	0.42857142857142855
3238	Sc_chr04	1071310	1071712	402	0.40547263681592044
3239	Sc_chr04	1071712	1071918	206	0.43203883495145634
3240	Sc_chr04	1071918	1072135	217	0.4423963133640553
3241	Sc_chr04	1072135	1072252	117	0.4188034188034188
3242	Sc_chr04	1072252	1072461	209	0.4066985645933014
3243	Sc_chr04	1072461	1072469	8	0.5
3244	Sc_chr04	1072469	1072768	299	0.34782608695652173
3245	Sc_chr04	1072768	1072804	36	0.36111111111111116
3246	Sc_chr04	1072804	1073008	204	0.4411764705882353
3247	Sc_chr04	1073008	1073212	204	0.37254901960784315
3248	Sc_chr04	1073212	1073249	37	0.3783783783783784
3249	Sc_chr04	1073249	1073482	233	0.34334763948497854
3250	Sc_chr04	1073482	1073503	21	0.42857142857142855
3251	Sc_chr04	1073503	1073763	260	0.29615384615384616
3252	Sc_chr04	1073763	1073918	155	0.4516129032258065
3253	Sc_chr04	1073918	1074130	212	0.36320754716981135
3254	Sc_chr04	1074130	1074317	187	0.3582887700534759
3255	Sc_chr04	1074317	1075398	1081	0.36725254394079554
3256	Sc_chr04	1075398	1075484	86	0.313953488372093
3257	Sc_chr04	1075484	1076160	676	0.3594674556213018
3258	Sc_chr04	1076160	1076747	587	0.33560477001703576
3259	Sc_chr04	1076747	1076754	7	0.42857142857142855
3260	Sc_chr04	1076754	1076932	178	0.3651685393258427
3261	Sc_chr04	1076932	1077232	300	0.38333333333333336
3262	Sc_chr04	1077232	1077587	355	0.35774647887323946
3263	Sc_chr04	1077587	1077603	16	0.4375
3264	Sc_chr04	1077603	1079545	1942	0.3486096807415036
3265	Sc_chr04	1079545	1079588	43	0.46511627906976744
3266	Sc_chr04	1079588	1079623	35	0.4
3267	Sc_chr04	1079623	1080068	445	0.40674157303370784
3268	Sc_chr04	1080068	1080267	199	0.4321608040201005
3269	Sc_chr04	1080267	1080401	134	0.36567164179104483
3270	Sc_chr04	1080401	1080426	25	0.4
3271	Sc_chr04	1080426	1080499	73	0.452054794520548
3272	Sc_chr04	1080499	1081337	838	0.42362768496420045
3273	Sc_chr04	1081337	1081380	43	0.37209302325581395
3274	Sc_chr04	1081380	1081748	368	0.391304347826087
3275	Sc_chr04	1081748	1082077	329	0.46200607902735563
3276	Sc_chr04	1082077	1082125	48	0.41666666666666663
3277	Sc_chr04	1082125	1082454	329	0.46504559270516715
3278	Sc_chr04	1082454	1082528	74	0.3918918918918919
3279	Sc_chr04	1082528	1082656	128	0.3125
3280	Sc_chr04	1082656	1082842	186	0.41935483870967744
3281	Sc_chr04	1082842	1083067	225	0.3244444444444444
3282	Sc_chr04	1083067	1084363	1296	0.39891975308641975
3283	Sc_chr04	1084363	1085963	1600	0.36875
3284	Sc_chr04	1085963	1086015	52	0.3846153846153846
3285	Sc_chr04	1086015	1086557	542	0.36900369003690037
3286	Sc_chr04	1086557	1087618	1061	0.3628652214891612
3287	Sc_chr04	1087618	1087726	108	0.41666666666666663
3288	Sc_chr04	1087726	1088031	305	0.36721311475409835
3289	Sc_chr04	1088031	1088045	14	0.42857142857142855
3290	Sc_chr04	1088045	1088152	107	0.3644859813084112
3291	Sc_chr04	1088152	1088221	69	0.3768115942028985
3292	Sc_chr04	1088221	1088321	100	0.28
3293	Sc_chr04	1088321	1088862	541	0.3807763401109057
3294	Sc_chr04	1088862	1089085	223	0.35874439461883406
3295	Sc_chr04	1089085	1089598	513	0.35867446393762187
3296	Sc_chr04	1089598	1089625	27	0.4074074074074074
3297	Sc_chr04	1089625	1089676	51	0.5098039215686274
3298	Sc_chr04	1089676	1090151	475	0.3957894736842105
3299	Sc_chr04	1090151	1090355	204	0.42647058823529416
3300	Sc_chr04	1090355	1090491	136	0.38235294117647056
3301	Sc_chr04	1090491	1090860	369	0.34417344173441733
3302	Sc_chr04	1090860	1091505	645	0.3581395348837209
3303	Sc_chr04	1091505	1092075	570	0.3701754385964912
3304	Sc_chr04	1092075	1092474	399	0.3308270676691729
3305	Sc_chr04	1092474	1092829	355	0.3408450704225352
3306	Sc_chr04	1092829	1093004	175	0.3542857142857143
3307	Sc_chr04	1093004	1093495	491	0.30549898167006106
3308	Sc_chr04	1093495	1093534	39	0.6153846153846154
3309	Sc_chr04	1093534	1093587	53	0.4716981132075472
3310	Sc_chr04	1093587	1093764	177	0.3502824858757062
3311	Sc_chr04	1093764	1093850	86	0.46511627906976744
3312	Sc_chr04	1093850	1094051	201	0.33333333333333337
3313	Sc_chr04	1094051	1094088	37	0.35135135135135137
3314	Sc_chr04	1094088	1094335	247	0.32793522267206476
3315	Sc_chr04	1094335	1094776	441	0.34240362811791386
3316	Sc_chr04	1094776	1095252	476	0.3487394957983193
3317	Sc_chr04	1095252	1095292	40	0.375
3318	Sc_chr04	1095292	1095382	90	0.36666666666666664
3319	Sc_chr04	1095382	1095567	185	0.3945945945945946
3320	Sc_chr04	1095567	1095576	9	0.4444444444444444
3321	Sc_chr04	1095576	1095915	339	0.29793510324483774
3322	Sc_chr04	1095915	1096153	238	0.32773109243697474
3323	Sc_chr04	1096153	1096695	542	0.4446494464944649
3324	Sc_chr04	1096695	1097117	422	0.3696682464454976
3325	Sc_chr04	1097117	1097472	355	0.4028169014084507
3326	Sc_chr04	1097472	1098593	1121	0.39250669045495096
3327	Sc_chr04	1098593	1098752	159	0.40880503144654085
3328	Sc_chr04	1098752	1098838	86	0.37209302325581395
3329	Sc_chr04	1098838	1098854	16	0.375
3330	Sc_chr04	1098854	1099071	217	0.4147465437788018
3331	Sc_chr04	1099071	1099451	380	0.4210526315789474
3332	Sc_chr04	1099451	1099466	15	0.6
3333	Sc_chr04	1099466	1099602	136	0.39705882352941174
3334	Sc_chr04	1099602	1099686	84	0.34523809523809523
3335	Sc_chr04	1099686	1101331	1645	0.3373860182370821
3336	Sc_chr04	1101331	1101503	172	0.313953488372093
3337	Sc_chr04	1101503	1101707	204	0.28921568627450983
3338	Sc_chr04	1101707	1102082	375	0.256
3339	Sc_chr04	1102082	1102175	93	0.29032258064516125
3340	Sc_chr04	1102175	1102229	54	0.3148148148148148
3341	Sc_chr04	1102229	1102439	210	0.30476190476190473
3342	Sc_chr04	1102439	1102665	226	0.34070796460176994
3343	Sc_chr04	1102665	1102695	30	0.26666666666666666
3344	Sc_chr04	1102695	1102706	11	0.5454545454545454
3345	Sc_chr04	1102706	1103288	582	0.36597938144329895
3346	Sc_chr04	1103288	1103609	321	0.3551401869158879
3347	Sc_chr04	1103609	1103990	381	0.3254593175853018
3348	Sc_chr04	1103990	1103999	9	0.33333333333333337
3349	Sc_chr04	1103999	1104212	213	0.39436619718309857
3350	Sc_chr04	1104212	1104520	308	0.36363636363636365
3351	Sc_chr04	1104520	1105406	886	0.3510158013544018
3352	Sc_chr04	1105406	1105473	67	0.26865671641791045
3353	Sc_chr04	1105473	1106719	1246	0.34269662921348315
3354	Sc_chr04	1106719	1106865	146	0.3767123287671233
3355	Sc_chr04	1106865	1107236	371	0.3719676549865229
3356	Sc_chr04	1107236	1107242	6	0.33333333333333337
3357	Sc_chr04	1107242	1107542	300	0.36666666666666664
3358	Sc_chr04	1107542	1107753	211	0.3744075829383886
3359	Sc_chr04	1107753	1108091	338	0.455621301775148
3360	Sc_chr04	1108091	1108200	109	0.4311926605504587
3361	Sc_chr04	1108200	1108956	756	0.3941798941798942
3362	Sc_chr04	1108956	1109648	692	0.3945086705202312
3363	Sc_chr04	1109648	1109665	17	0.35294117647058826
3364	Sc_chr04	1109665	1110555	890	0.302247191011236
3365	Sc_chr04	1110555	1110598	43	0.3953488372093023
3366	Sc_chr04	1110598	1110838	240	0.37083333333333335
3367	Sc_chr04	1110838	1110914	76	0.368421052631579
3368	Sc_chr04	1110914	1111160	246	0.38211382113821135
3369	Sc_chr04	1111160	1111371	211	0.33649289099526064
3370	Sc_chr04	1111371	1111690	319	0.4231974921630094
3371	Sc_chr04	1111690	1112067	377	0.2917771883289125
3372	Sc_chr04	1112067	1112411	344	0.36627906976744184
3373	Sc_chr04	1112411	1112457	46	0.5434782608695652
3374	Sc_chr04	1112457	1112563	106	0.34905660377358494
3375	Sc_chr04	1112563	1112686	123	0.3983739837398374
3376	Sc_chr04	1112686	1112830	144	0.41666666666666663
3377	Sc_chr04	1112830	1112946	116	0.32758620689655177
3378	Sc_chr04	1112946	1112964	18	0.33333333333333337
3379	Sc_chr04	1112964	1113225	261	0.3601532567049809
3380	Sc_chr04	1113225	1113455	230	0.3695652173913044
3381	Sc_chr04	1113455	1113863	408	0.36764705882352944
3382	Sc_chr04	1113863	1114020	157	0.35668789808917195
3383	Sc_chr04	1114020	1114076	56	0.375
3384	Sc_chr04	1114076	1114115	39	0.4615384615384615
3385	Sc_chr04	1114115	1115170	1055	0.33649289099526064
3386	Sc_chr04	1115170	1115265	95	0.35789473684210527
3387	Sc_chr04	1115265	1116009	744	0.3629032258064516
3388	Sc_chr04	1116009	1116470	461	0.42082429501084595
3389	Sc_chr04	1116470	1116548	78	0.3717948717948718
3390	Sc_chr04	1116548	1117053	505	0.35445544554455444
3391	Sc_chr04	1117053	1117131	78	0.4358974358974359
3392	Sc_chr04	1117131	1117316	185	0.3567567567567568
3393	Sc_chr04	1117316	1117470	154	0.3701298701298701
3394	Sc_chr04	1117470	1117773	303	0.33993399339933994
3395	Sc_chr04	1117773	1117814	41	0.5121951219512195
3396	Sc_chr04	1117814	1117953	139	0.35251798561151076
3397	Sc_chr04	1117953	1118089	136	0.36764705882352944
3398	Sc_chr04	1118089	1118446	357	0.3473389355742297
3399	Sc_chr04	1118446	1118942	496	0.3709677419354838
3400	Sc_chr04	1118942	1119555	613	0.4029363784665579
3401	Sc_chr04	1119555	1119620	65	0.3692307692307692
3402	Sc_chr04	1119620	1119674	54	0.3148148148148148
3403	Sc_chr04	1119674	1119842	168	0.3035714285714286
3404	Sc_chr04	1119842	1120063	221	0.3574660633484163
3405	Sc_chr04	1120063	1120536	473	0.3171247357293869
3406	Sc_chr04	1120536	1120721	185	0.31891891891891894
3407	Sc_chr04	1120721	1120814	93	0.3655913978494624
3408	Sc_chr04	1120814	1121276	462	0.30952380952380953
3409	Sc_chr04	1121276	1121402	126	0.38888888888888884
3410	Sc_chr04	1121402	1121467	65	0.4153846153846154
3411	Sc_chr04	1121467	1121586	119	0.33613445378151263
3412	Sc_chr04	1121586	1121780	194	0.31958762886597936
3413	Sc_chr04	1121780	1121964	184	0.3369565217391305
3414	Sc_chr04	1121964	1122150	186	0.3548387096774194
3415	Sc_chr04	1122150	1122279	129	0.34883720930232553
3416	Sc_chr04	1122279	1122368	89	0.3146067415730337
3417	Sc_chr04	1122368	1122458	90	0.36666666666666664
3418	Sc_chr04	1122458	1122657	199	0.3869346733668342
3419	Sc_chr04	1122657	1122923	266	0.36466165413533835
3420	Sc_chr04	1122923	1123182	259	0.34749034749034746
3421	Sc_chr04	1123182	1123216	34	0.35294117647058826
3422	Sc_chr04	1123216	1123565	349	0.3524355300859599
3423	Sc_chr04	1123565	1123594	29	0.27586206896551724
3424	Sc_chr04	1123594	1123693	99	0.4343434343434343
3425	Sc_chr04	1123693	1124497	804	0.40547263681592044
3426	Sc_chr04	1124497	1125406	909	0.36633663366336633
3427	Sc_chr04	1125406	1125544	138	0.4782608695652174
3428	Sc_chr04	1125544	1125941	397	0.473551637279597
3429	Sc_chr04	1125941	1126328	387	0.4108527131782946
3430	Sc_chr04	1126328	1126472	144	0.5
3431	Sc_chr04	1126472	1127006	534	0.3820224719101124
3432	Sc_chr04	1127006	1127184	178	0.4269662921348315
3433	Sc_chr04	1127184	1127415	231	0.3939393939393939
3434	Sc_chr04	1127415	1127575	160	0.425
3435	Sc_chr04	1127575	1127804	229	0.3668122270742358
3436	Sc_chr04	1127804	1128783	979	0.4269662921348315
3437	Sc_chr04	1128783	1128885	102	0.43137254901960786
3438	Sc_chr04	1128885	1128933	48	0.45833333333333337
3439	Sc_chr04	1128933	1129065	132	0.4015151515151515
3440	Sc_chr04	1129065	1129121	56	0.5
3441	Sc_chr04	1129121	1129266	145	0.4068965517241379
3442	Sc_chr04	1129266	1129884	618	0.37216828478964403
3443	Sc_chr04	1129884	1130430	546	0.3846153846153846
3444	Sc_chr04	1130430	1130547	117	0.33333333333333337
3445	Sc_chr04	1130547	1131272	725	0.33655172413793105
3446	Sc_chr04	1131272	1131516	244	0.38114754098360654
3447	Sc_chr04	1131516	1131650	134	0.3880597014925373
3448	Sc_chr04	1131650	1133053	1403	0.3585174625801853
3449	Sc_chr04	1133053	1133160	107	0.31775700934579443
3450	Sc_chr04	1133160	1133603	443	0.34762979683972917
3451	Sc_chr04	1133603	1133795	192	0.38541666666666663
3452	Sc_chr04	1133795	1134020	225	0.3644444444444444
3453	Sc_chr04	1134020	1134047	27	0.4444444444444444
3454	Sc_chr04	1134047	1134274	227	0.35242290748898675
3455	Sc_chr04	1134274	1134371	97	0.3505154639175258
3456	Sc_chr04	1134371	1134542	171	0.36257309941520466
3457	Sc_chr04	1134542	1134591	49	0.3877551020408163
3458	Sc_chr04	1134591	1134606	15	0.4
3459	Sc_chr04	1134606	1134665	59	0.4745762711864407
3460	Sc_chr04	1134665	1134893	228	0.39473684210526316
3461	Sc_chr04	1134893	1135985	1092	0.36721611721611724
3462	Sc_chr04	1135985	1136012	27	0.4074074074074074
3463	Sc_chr04	1136012	1136069	57	0.33333333333333337
3464	Sc_chr04	1136069	1136189	120	0.4083333333333334
3465	Sc_chr04	1136189	1136339	150	0.38
3466	Sc_chr04	1136339	1136486	147	0.36054421768707484
3467	Sc_chr04	1136486	1136969	483	0.3643892339544514
3468	Sc_chr04	1136969	1136987	18	0.4444444444444444
3469	Sc_chr04	1136987	1137698	711	0.3839662447257384
3470	Sc_chr04	1137698	1138355	657	0.3911719939117199
3471	Sc_chr04	1138355	1138428	73	0.3561643835616438
3472	Sc_chr04	1138428	1138586	158	0.3987341772151899
3473	Sc_chr04	1138586	1139455	869	0.3532796317606444
3474	Sc_chr04	1139455	1139821	366	0.39344262295081966
3475	Sc_chr04	1139821	1139895	74	0.3783783783783784
3476	Sc_chr04	1139895	1140171	276	0.3804347826086956
3477	Sc_chr04	1140171	1140242	71	0.4647887323943662
3478	Sc_chr04	1140242	1140442	200	0.43
3479	Sc_chr04	1140442	1140721	279	0.41935483870967744
3480	Sc_chr04	1140721	1140909	188	0.38829787234042556
3481	Sc_chr04	1140909	1140945	36	0.41666666666666663
3482	Sc_chr04	1140945	1142082	1137	0.36059806508355324
3483	Sc_chr04	1142082	1142139	57	0.2982456140350877
3484	Sc_chr04	1142139	1142198	59	0.288135593220339
3485	Sc_chr04	1142198	1142388	190	0.35789473684210527
3486	Sc_chr04	1142388	1142732	344	0.35174418604651164
3487	Sc_chr04	1142732	1143152	420	0.3357142857142857
3488	Sc_chr04	1143152	1143210	58	0.3448275862068966
3489	Sc_chr04	1143210	1143299	89	0.3820224719101124
3490	Sc_chr04	1143299	1143498	199	0.37185929648241206
3491	Sc_chr04	1143498	1143573	75	0.44
3492	Sc_chr04	1143573	1144089	516	0.4050387596899225
3493	Sc_chr04	1144089	1144791	702	0.35185185185185186
3494	Sc_chr04	1144791	1145451	660	0.34393939393939393
3495	Sc_chr04	1145451	1145657	206	0.3980582524271845
3496	Sc_chr04	1145657	1145798	141	0.39716312056737585
3497	Sc_chr04	1145798	1145988	190	0.3631578947368421
3498	Sc_chr04	1145988	1146034	46	0.2608695652173913
3499	Sc_chr04	1146034	1146144	110	0.36363636363636365
3500	Sc_chr04	1146144	1146388	244	0.36475409836065575
3501	Sc_chr04	1146388	1146510	122	0.4016393442622951
3502	Sc_chr04	1146510	1147410	900	0.36111111111111116
3503	Sc_chr04	1147410	1147779	369	0.40379403794037944
3504	Sc_chr04	1147779	1147960	181	0.3977900552486188
3505	Sc_chr04	1147960	1148845	885	0.3977401129943503
3506	Sc_chr04	1148845	1149284	439	0.40774487471526194
3507	Sc_chr04	1149284	1149300	16	0.4375
3508	Sc_chr04	1149300	1150153	853	0.37397420867526376
3509	Sc_chr04	1150153	1151670	1517	0.3256427158866183
3510	Sc_chr04	1151670	1152133	463	0.37580993520518363
3511	Sc_chr04	1152133	1152437	304	0.3848684210526316
3512	Sc_chr04	1152437	1152654	217	0.3778801843317972
3513	Sc_chr04	1152654	1152980	326	0.3711656441717791
3514	Sc_chr04	1152980	1153132	152	0.38815789473684215
3515	Sc_chr04	1153132	1154061	929	0.3681377825618945
3516	Sc_chr04	1154061	1154186	125	0.2
3517	Sc_chr04	1154186	1154950	764	0.4096858638743456
3518	Sc_chr04	1154950	1155069	119	0.4621848739495798
3519	Sc_chr04	1155069	1155121	52	0.4230769230769231
3520	Sc_chr04	1155121	1155712	591	0.39086294416243655
3521	Sc_chr04	1155712	1156170	458	0.3471615720524017
3522	Sc_chr04	1156170	1156904	734	0.4128065395095368
3523	Sc_chr04	1156904	1156981	77	0.36363636363636365
3524	Sc_chr04	1156981	1157269	288	0.3125
3525	Sc_chr04	1157269	1157373	104	0.3557692307692308
3526	Sc_chr04	1157373	1157708	335	0.41194029850746267
3527	Sc_chr04	1157708	1157736	28	0.4642857142857143
3528	Sc_chr04	1157736	1157772	36	0.41666666666666663
3529	Sc_chr04	1157772	1157986	214	0.35046728971962615
3530	Sc_chr04	1157986	1158961	975	0.35179487179487184
3531	Sc_chr04	1158961	1159071	110	0.32727272727272727
3532	Sc_chr04	1159071	1159090	19	0.3157894736842105
3533	Sc_chr04	1159090	1159578	488	0.3340163934426229
3534	Sc_chr04	1159578	1160342	764	0.40706806282722513
3535	Sc_chr04	1160342	1160461	119	0.4621848739495798
3536	Sc_chr04	1160461	1160513	52	0.4230769230769231
3537	Sc_chr04	1160513	1161104	591	0.39086294416243655
3538	Sc_chr04	1161104	1161555	451	0.3547671840354767
3539	Sc_chr04	1161555	1161854	299	0.39464882943143814
3540	Sc_chr04	1161854	1162786	932	0.4259656652360515
3541	Sc_chr04	1162786	1163522	736	0.3763586956521739
3542	Sc_chr04	1163522	1163676	154	0.3701298701298701
3543	Sc_chr04	1163676	1163919	243	0.448559670781893
3544	Sc_chr04	1163919	1165904	1985	0.3949622166246851
3545	Sc_chr04	1165904	1165928	24	0.20833333333333331
3546	Sc_chr04	1165928	1166357	429	0.3496503496503497
3547	Sc_chr04	1166357	1166631	274	0.38321167883211676
3548	Sc_chr04	1166631	1166645	14	0.5
3549	Sc_chr04	1166645	1166680	35	0.4
3550	Sc_chr04	1166680	1166801	121	0.3140495867768595
3551	Sc_chr04	1166801	1167332	531	0.3408662900188324
3552	Sc_chr04	1167332	1167465	133	0.406015037593985
3553	Sc_chr04	1167465	1167618	153	0.3856209150326797
3554	Sc_chr04	1167618	1167914	296	0.3817567567567568
3555	Sc_chr04	1167914	1168163	249	0.40963855421686746
3556	Sc_chr04	1168163	1168632	469	0.3944562899786781
3557	Sc_chr04	1168632	1168730	98	0.2755102040816326
3558	Sc_chr04	1168730	1169098	368	0.3831521739130435
3559	Sc_chr04	1169098	1170118	1020	0.411764705882353
3560	Sc_chr04	1170118	1170453	335	0.3582089552238806
3561	Sc_chr04	1170453	1170623	170	0.4235294117647059
3562	Sc_chr04	1170623	1171211	588	0.4421768707482993
3563	Sc_chr04	1171211	1171298	87	0.47126436781609193
3564	Sc_chr04	1171298	1171315	17	0.411764705882353
3565	Sc_chr04	1171315	1171590	275	0.41454545454545455
3566	Sc_chr04	1171590	1172014	424	0.36320754716981135
3567	Sc_chr04	1172014	1172131	117	0.33333333333333337
3568	Sc_chr04	1172131	1172235	104	0.4519230769230769
3569	Sc_chr04	1172235	1172456	221	0.32579185520361986
3570	Sc_chr04	1172456	1172778	322	0.4316770186335404
3571	Sc_chr04	1172778	1173392	614	0.4039087947882736
3572	Sc_chr04	1173392	1173434	42	0.4523809523809524
3573	Sc_chr04	1173434	1174227	793	0.4060529634300126
3574	Sc_chr04	1174227	1174471	244	0.36885245901639346
3575	Sc_chr04	1174471	1175273	802	0.33416458852867836
3576	Sc_chr04	1175273	1175306	33	0.48484848484848486
3577	Sc_chr04	1175306	1176849	1543	0.35255994815294883
3578	Sc_chr04	1176849	1177947	1098	0.3579234972677595
3579	Sc_chr04	1177947	1178259	312	0.4134615384615385
3580	Sc_chr04	1178259	1178315	56	0.3035714285714286
3581	Sc_chr04	1178315	1178381	66	0.3181818181818182
3582	Sc_chr04	1178381	1178410	29	0.3103448275862069
3583	Sc_chr04	1178410	1178840	430	0.3581395348837209
3584	Sc_chr04	1178840	1179215	375	0.4053333333333333
3585	Sc_chr04	1179215	1179353	138	0.43478260869565216
3586	Sc_chr04	1179353	1179474	121	0.4214876033057851
3587	Sc_chr04	1179474	1179631	157	0.3312101910828026
3588	Sc_chr04	1179631	1180073	442	0.3846153846153846
3589	Sc_chr04	1180073	1180714	641	0.35257410296411856
3590	Sc_chr04	1180714	1181042	328	0.34451219512195125
3591	Sc_chr04	1181042	1181608	566	0.32685512367491165
3592	Sc_chr04	1181608	1181846	238	0.3403361344537815
3593	Sc_chr04	1181846	1183568	1722	0.41289198606271776
3594	Sc_chr04	1183568	1184941	1373	0.3991260014566642
3595	Sc_chr04	1184941	1185004	63	0.4920634920634921
3596	Sc_chr04	1185004	1185559	555	0.4306306306306306
3597	Sc_chr04	1185559	1185804	245	0.42448979591836733
3598	Sc_chr04	1185804	1186766	962	0.36174636174636177
3599	Sc_chr04	1186766	1186899	133	0.3308270676691729
3600	Sc_chr04	1186899	1187417	518	0.32818532818532814
3601	Sc_chr04	1187417	1187880	463	0.30885529157667385
3602	Sc_chr04	1187880	1187911	31	0.25806451612903225
3603	Sc_chr04	1187911	1188326	415	0.3204819277108434
3604	Sc_chr04	1188326	1188575	249	0.321285140562249
3605	Sc_chr04	1188575	1188586	11	0.36363636363636365
3606	Sc_chr04	1188586	1188698	112	0.4017857142857143
3607	Sc_chr04	1188698	1188870	172	0.38953488372093026
3608	Sc_chr04	1188870	1188996	126	0.41269841269841273
3609	Sc_chr04	1188996	1189060	64	0.421875
3610	Sc_chr04	1189060	1189515	455	0.3274725274725274
3611	Sc_chr04	1189515	1190149	634	0.34858044164037855
3612	Sc_chr04	1190149	1190373	224	0.40625
3613	Sc_chr04	1190373	1190493	120	0.41666666666666663
3614	Sc_chr04	1190493	1190838	345	0.391304347826087
3615	Sc_chr04	1190838	1190964	126	0.36507936507936506
3616	Sc_chr04	1190964	1190972	8	0.375
3617	Sc_chr04	1190972	1191144	172	0.37209302325581395
3618	Sc_chr04	1191144	1191408	264	0.37121212121212127
3619	Sc_chr04	1191408	1191492	84	0.34523809523809523
3620	Sc_chr04	1191492	1191906	414	0.35265700483091783
3621	Sc_chr04	1191906	1192918	1012	0.4169960474308301
3622	Sc_chr04	1192918	1193294	376	0.35904255319148937
3623	Sc_chr04	1193294	1193398	104	0.3557692307692308
3624	Sc_chr04	1193398	1193833	435	0.4
3625	Sc_chr04	1193833	1194160	327	0.3730886850152906
3626	Sc_chr04	1194160	1194196	36	0.4722222222222222
3627	Sc_chr04	1194196	1195233	1037	0.40790742526518803
3628	Sc_chr04	1195233	1195384	151	0.45033112582781454
3629	Sc_chr04	1195384	1195467	83	0.3493975903614458
3630	Sc_chr04	1195467	1195598	131	0.3816793893129771
3631	Sc_chr04	1195598	1195938	340	0.36470588235294116
3632	Sc_chr04	1195938	1195987	49	0.4489795918367347
3633	Sc_chr04	1195987	1196119	132	0.37121212121212127
3634	Sc_chr04	1196119	1196982	863	0.3348783314020857
3635	Sc_chr04	1196982	1197340	358	0.44134078212290506
3636	Sc_chr04	1197340	1197592	252	0.38492063492063494
3637	Sc_chr04	1197592	1197956	364	0.39560439560439564
3638	Sc_chr04	1197956	1198054	98	0.30612244897959184
3639	Sc_chr04	1198054	1198210	156	0.34615384615384615
3640	Sc_chr04	1198210	1198761	551	0.41379310344827586
3641	Sc_chr04	1198761	1199227	466	0.3690987124463519
3642	Sc_chr04	1199227	1199305	78	0.3205128205128205
3643	Sc_chr04	1199305	1199441	136	0.41911764705882354
3644	Sc_chr04	1199441	1199519	78	0.39743589743589747
3645	Sc_chr04	1199519	1199594	75	0.3466666666666666
3646	Sc_chr04	1199594	1199624	30	0.4666666666666666
3647	Sc_chr04	1199624	1200469	845	0.3562130177514793
3648	Sc_chr04	1200469	1200505	36	0.38888888888888884
3649	Sc_chr04	1200505	1200819	314	0.36624203821656054
3650	Sc_chr04	1200819	1201042	223	0.31390134529147984
3651	Sc_chr04	1201042	1201263	221	0.3393665158371041
3652	Sc_chr04	1201263	1201360	97	0.3505154639175258
3653	Sc_chr04	1201360	1201976	616	0.31006493506493504
3654	Sc_chr04	1201976	1202652	676	0.3357988165680474
3655	Sc_chr04	1202652	1203238	586	0.3583617747440273
3656	Sc_chr04	1203238	1203339	101	0.38613861386138615
3657	Sc_chr04	1203339	1203378	39	0.3846153846153846
3658	Sc_chr04	1203378	1203657	279	0.3655913978494624
3659	Sc_chr04	1203657	1203795	138	0.4057971014492754
3660	Sc_chr04	1203795	1203942	147	0.43537414965986393
3661	Sc_chr04	1203942	1204714	772	0.344559585492228
3662	Sc_chr04	1204714	1204741	27	0.33333333333333337
3663	Sc_chr04	1204741	1204824	83	0.3493975903614458
3664	Sc_chr04	1204824	1204943	119	0.35294117647058826
3665	Sc_chr04	1204943	1205683	740	0.3945945945945946
3666	Sc_chr04	1205683	1206203	520	0.3711538461538461
3667	Sc_chr04	1206203	1206250	47	0.4042553191489362
3668	Sc_chr04	1206250	1206281	31	0.3548387096774194
3669	Sc_chr04	1206281	1206289	8	0.25
3670	Sc_chr04	1206289	1206319	30	0.3
3671	Sc_chr04	1206319	1206329	10	0.5
3672	Sc_chr04	1206329	1206409	80	0.45
3673	Sc_chr04	1206409	1206551	142	0.3098591549295775
3674	Sc_chr04	1206551	1206851	300	0.38
3675	Sc_chr04	1206851	1207086	235	0.32340425531914896
3676	Sc_chr04	1207086	1207628	542	0.45018450184501846
3677	Sc_chr04	1207628	1208050	422	0.3696682464454976
3678	Sc_chr04	1208050	1208405	355	0.4112676056338028
3679	Sc_chr04	1208405	1208639	234	0.37606837606837606
3680	Sc_chr04	1208639	1209526	887	0.39797068771138666
3681	Sc_chr04	1209526	1209685	159	0.40880503144654085
3682	Sc_chr04	1209685	1209771	86	0.37209302325581395
3683	Sc_chr04	1209771	1209787	16	0.375
3684	Sc_chr04	1209787	1210004	217	0.4147465437788018
3685	Sc_chr04	1210004	1210384	380	0.4210526315789474
3686	Sc_chr04	1210384	1210399	15	0.6
3687	Sc_chr04	1210399	1210535	136	0.4044117647058823
3688	Sc_chr04	1210535	1210619	84	0.34523809523809523
3689	Sc_chr04	1210619	1212056	1437	0.3465553235908142
3690	Sc_chr04	1212056	1212063	7	0.42857142857142855
3691	Sc_chr04	1212063	1212264	201	0.3034825870646766
3692	Sc_chr04	1212264	1212435	171	0.30994152046783624
3693	Sc_chr04	1212435	1212773	338	0.28402366863905326
3694	Sc_chr04	1212773	1212851	78	0.33333333333333337
3695	Sc_chr04	1212851	1214167	1316	0.3594224924012158
3696	Sc_chr04	1214167	1214819	652	0.39263803680981596
3697	Sc_chr04	1214819	1214895	76	0.4473684210526316
3698	Sc_chr04	1214895	1215106	211	0.33649289099526064
3699	Sc_chr04	1215106	1215254	148	0.3716216216216216
3700	Sc_chr04	1215254	1215394	140	0.35714285714285715
3701	Sc_chr04	1215394	1215445	51	0.29411764705882354
3702	Sc_chr04	1215445	1216595	1150	0.3852173913043478
3703	Sc_chr04	1216595	1216922	327	0.327217125382263
3704	Sc_chr04	1216922	1217393	471	0.35244161358811044
3705	Sc_chr04	1217393	1217482	89	0.29213483146067415
3706	Sc_chr04	1217482	1218386	904	0.3418141592920354
3707	Sc_chr04	1218386	1218570	184	0.358695652173913
3708	Sc_chr04	1218570	1219406	836	0.3672248803827751
3709	Sc_chr04	1219406	1219437	31	0.4838709677419355
3710	Sc_chr04	1219437	1219784	347	0.35158501440922185
3711	Sc_chr04	1219784	1220066	282	0.3120567375886525
3712	Sc_chr04	1220066	1220189	123	0.4308943089430894
3713	Sc_chr04	1220189	1220261	72	0.3194444444444444
3714	Sc_chr04	1220261	1220389	128	0.375
3715	Sc_chr04	1220389	1220621	232	0.3620689655172413
3716	Sc_chr04	1220621	1221373	752	0.3204787234042554
3717	Sc_chr04	1221373	1221630	257	0.3696498054474708
3718	Sc_chr04	1221630	1221665	35	0.3142857142857143
3719	Sc_chr04	1221665	1221782	117	0.358974358974359
3720	Sc_chr04	1221782	1222205	423	0.3546099290780142
3721	Sc_chr04	1222205	1222455	250	0.336
3722	Sc_chr04	1222455	1222468	13	0.6153846153846154
3723	Sc_chr04	1222468	1222560	92	0.34782608695652173
3724	Sc_chr04	1222560	1223210	650	0.3492307692307692
3725	Sc_chr04	1223210	1223283	73	0.3972602739726028
3726	Sc_chr04	1223283	1223630	347	0.26512968299711814
3727	Sc_chr04	1223630	1223653	23	0.34782608695652173
3728	Sc_chr04	1223653	1224172	519	0.34104046242774566
3729	Sc_chr04	1224172	1224277	105	0.32380952380952377
3730	Sc_chr04	1224277	1224828	551	0.3666061705989111
3731	Sc_chr04	1224828	1224852	24	0.41666666666666663
3732	Sc_chr04	1224852	1225724	872	0.3738532110091743
3733	Sc_chr04	1225724	1226156	432	0.4351851851851852
3734	Sc_chr04	1226156	1226327	171	0.4210526315789474
3735	Sc_chr04	1226327	1226356	29	0.4482758620689655
3736	Sc_chr04	1226356	1226885	529	0.3818525519848771
3737	Sc_chr04	1226885	1227010	125	0.41600000000000004
3738	Sc_chr04	1227010	1227574	564	0.3776595744680851
3739	Sc_chr04	1227574	1227619	45	0.33333333333333337
3740	Sc_chr04	1227619	1227964	345	0.3652173913043478
3741	Sc_chr04	1227964	1228041	77	0.37662337662337664
3742	Sc_chr04	1228041	1228307	266	0.4323308270676691
3743	Sc_chr04	1228307	1228362	55	0.21818181818181817
3744	Sc_chr04	1228362	1229199	837	0.3488649940262844
3745	Sc_chr04	1229199	1230011	812	0.3731527093596059
3746	Sc_chr04	1230011	1230015	4	0.5
3747	Sc_chr04	1230015	1230623	608	0.350328947368421
3748	Sc_chr04	1230623	1230724	101	0.42574257425742573
3749	Sc_chr04	1230724	1231009	285	0.3894736842105263
3750	Sc_chr04	1231009	1231017	8	0.625
3751	Sc_chr04	1231017	1231460	443	0.381489841986456
3752	Sc_chr04	1231460	1231913	453	0.40176600441501104
3753	Sc_chr04	1231913	1231937	24	0.41666666666666663
3754	Sc_chr04	1231937	1232326	389	0.3701799485861183
3755	Sc_chr04	1232326	1232341	15	0.6
3756	Sc_chr04	1232341	1232525	184	0.41847826086956524
3757	Sc_chr04	1232525	1232593	68	0.39705882352941174
3758	Sc_chr04	1232593	1232673	80	0.4375
3759	Sc_chr04	1232673	1232803	130	0.34615384615384615
3760	Sc_chr04	1232803	1232842	39	0.33333333333333337
3761	Sc_chr04	1232842	1234129	1287	0.35975135975135974
3762	Sc_chr04	1234129	1234278	149	0.37583892617449666
3763	Sc_chr04	1234278	1234634	356	0.4241573033707865
3764	Sc_chr04	1234634	1234990	356	0.35955056179775285
3765	Sc_chr04	1234990	1235450	460	0.34565217391304354
3766	Sc_chr04	1235450	1236945	1495	0.4020066889632107
3767	Sc_chr04	1236945	1237260	315	0.3619047619047619
3768	Sc_chr04	1237260	1237765	505	0.3465346534653465
3769	Sc_chr04	1237765	1237794	29	0.3448275862068966
3770	Sc_chr04	1237794	1237832	38	0.5
3771	Sc_chr04	1237832	1237962	130	0.4307692307692308
3772	Sc_chr04	1237962	1239204	1242	0.33816425120772947
3773	Sc_chr04	1239204	1239256	52	0.4230769230769231
3774	Sc_chr04	1239256	1239403	147	0.27210884353741494
3775	Sc_chr04	1239403	1240267	864	0.36689814814814814
3776	Sc_chr04	1240267	1241382	1115	0.3542600896860986
3777	Sc_chr04	1241382	1241505	123	0.4390243902439025
3778	Sc_chr04	1241505	1241560	55	0.45454545454545453
3779	Sc_chr04	1241560	1241870	310	0.4838709677419355
3780	Sc_chr04	1241870	1242957	1087	0.42042318307267706
3781	Sc_chr04	1242957	1243313	356	0.35674157303370785
3782	Sc_chr04	1243313	1243525	212	0.4386792452830188
3783	Sc_chr04	1243525	1243534	9	0.33333333333333337
3784	Sc_chr04	1243534	1244345	811	0.45129469790382243
3785	Sc_chr04	1244345	1244606	261	0.4482758620689655
3786	Sc_chr04	1244606	1244771	165	0.4303030303030303
3787	Sc_chr04	1244771	1244893	122	0.43442622950819676
3788	Sc_chr04	1244893	1245124	231	0.4415584415584416
3789	Sc_chr04	1245124	1245273	149	0.4563758389261745
3790	Sc_chr04	1245273	1245389	116	0.4396551724137931
3791	Sc_chr04	1245389	1245397	8	0.375
3792	Sc_chr04	1245397	1245991	594	0.38552188552188554
3793	Sc_chr04	1245991	1246236	245	0.3510204081632653
3794	Sc_chr04	1246236	1246492	256	0.375
3795	Sc_chr04	1246492	1247028	536	0.40298507462686567
3796	Sc_chr04	1247028	1247145	117	0.3846153846153846
3797	Sc_chr04	1247145	1247172	27	0.33333333333333337
3798	Sc_chr04	1247172	1247586	414	0.3743961352657005
3799	Sc_chr04	1247586	1247733	147	0.37414965986394555
3800	Sc_chr04	1247733	1248400	667	0.3463268365817091
3801	Sc_chr04	1248400	1249386	986	0.4026369168356998
3802	Sc_chr04	1249386	1249543	157	0.3885350318471337
3803	Sc_chr04	1249543	1249607	64	0.421875
3804	Sc_chr04	1249607	1249784	177	0.4180790960451977
3805	Sc_chr04	1249784	1250269	485	0.39587628865979385
3806	Sc_chr04	1250269	1250542	273	0.4249084249084249
3807	Sc_chr04	1250542	1251127	585	0.3811965811965812
3808	Sc_chr04	1251127	1252166	1039	0.48989412897016366
3809	Sc_chr04	1252166	1252174	8	0.625
3810	Sc_chr04	1252174	1252307	133	0.3383458646616541
3811	Sc_chr04	1252307	1252669	362	0.350828729281768
3812	Sc_chr04	1252669	1253248	579	0.41450777202072536
3813	Sc_chr04	1253248	1253802	554	0.3808664259927798
3814	Sc_chr04	1253802	1253822	20	0.3
3815	Sc_chr04	1253822	1254171	349	0.41260744985673353
3816	Sc_chr04	1254171	1254253	82	0.4634146341463415
3817	Sc_chr04	1254253	1254308	55	0.3818181818181818
3818	Sc_chr04	1254308	1254339	31	0.4516129032258065
3819	Sc_chr04	1254339	1254433	94	0.3404255319148936
3820	Sc_chr04	1254433	1254845	412	0.31553398058252424
3821	Sc_chr04	1254845	1254851	6	0.33333333333333337
3822	Sc_chr04	1254851	1255047	196	0.33673469387755106
3823	Sc_chr04	1255047	1255068	21	0.5238095238095238
3824	Sc_chr04	1255068	1255284	216	0.39351851851851855
3825	Sc_chr04	1255284	1255358	74	0.33783783783783783
3826	Sc_chr04	1255358	1255889	531	0.3728813559322034
3827	Sc_chr04	1255889	1256876	987	0.369807497467072
3828	Sc_chr04	1256876	1257085	209	0.3923444976076555
3829	Sc_chr04	1257085	1257428	343	0.3323615160349854
3830	Sc_chr04	1257428	1257804	376	0.39893617021276595
3831	Sc_chr04	1257804	1258322	518	0.3976833976833977
3832	Sc_chr04	1258322	1258592	270	0.41851851851851857
3833	Sc_chr04	1258592	1258895	303	0.4323432343234323
3834	Sc_chr04	1258895	1259835	940	0.3904255319148936
3835	Sc_chr04	1259835	1260164	329	0.36170212765957444
3836	Sc_chr04	1260164	1260879	715	0.3678321678321678
3837	Sc_chr04	1260879	1261003	124	0.4032258064516129
3838	Sc_chr04	1261003	1261989	986	0.3691683569979716
3839	Sc_chr04	1261989	1262265	276	0.41666666666666663
3840	Sc_chr04	1262265	1262544	279	0.43727598566308246
3841	Sc_chr04	1262544	1262598	54	0.42592592592592593
3842	Sc_chr04	1262598	1262834	236	0.46610169491525427
3843	Sc_chr04	1262834	1262895	61	0.4098360655737705
3844	Sc_chr04	1262895	1263528	633	0.36018957345971564
3845	Sc_chr04	1263528	1263580	52	0.3846153846153846
3846	Sc_chr04	1263580	1263891	311	0.3890675241157556
3847	Sc_chr04	1263891	1264049	158	0.3544303797468354
3848	Sc_chr04	1264049	1264310	261	0.3448275862068966
3849	Sc_chr04	1264310	1265453	1143	0.37270341207349084
3850	Sc_chr04	1265453	1266391	938	0.3507462686567164
3851	Sc_chr04	1266391	1266596	205	0.3951219512195122
3852	Sc_chr04	1266596	1266665	69	0.5652173913043478
3853	Sc_chr04	1266665	1266773	108	0.3796296296296296
3854	Sc_chr04	1266773	1267138	365	0.4273972602739726
3855	Sc_chr04	1267138	1267857	719	0.39499304589707923
3856	Sc_chr04	1267857	1268241	384	0.38541666666666663
3857	Sc_chr04	1268241	1268493	252	0.35714285714285715
3858	Sc_chr04	1268493	1268499	6	0.6666666666666667
3859	Sc_chr04	1268499	1268514	15	0.4
3860	Sc_chr04	1268514	1268814	300	0.43333333333333335
3861	Sc_chr04	1268814	1269517	703	0.4153627311522048
3862	Sc_chr04	1269517	1269544	27	0.48148148148148145
3863	Sc_chr04	1269544	1270201	657	0.3637747336377473
3864	Sc_chr04	1270201	1270364	163	0.4049079754601227
3865	Sc_chr04	1270364	1271098	734	0.39782016348773847
3866	Sc_chr04	1271098	1271596	498	0.42369477911646586
3867	Sc_chr04	1271596	1271626	30	0.4666666666666666
3868	Sc_chr04	1271626	1271824	198	0.3585858585858586
3869	Sc_chr04	1271824	1271866	42	0.4761904761904762
3870	Sc_chr04	1271866	1272031	165	0.3696969696969697
3871	Sc_chr04	1272031	1272535	504	0.36904761904761907
3872	Sc_chr04	1272535	1272715	180	0.4
3873	Sc_chr04	1272715	1272898	183	0.39344262295081966
3874	Sc_chr04	1272898	1273199	301	0.34219269102990035
3875	Sc_chr04	1273199	1273534	335	0.37910447761194027
3876	Sc_chr04	1273534	1273552	18	0.4444444444444444
3877	Sc_chr04	1273552	1274232	680	0.3411764705882353
3878	Sc_chr04	1274232	1275168	936	0.35149572649572647
3879	Sc_chr04	1275168	1275225	57	0.33333333333333337
3880	Sc_chr04	1275225	1275573	348	0.40804597701149425
3881	Sc_chr04	1275573	1275830	257	0.377431906614786
3882	Sc_chr04	1275830	1276390	560	0.34285714285714286
3883	Sc_chr04	1276390	1277320	930	0.378494623655914
3884	Sc_chr04	1277320	1277450	130	0.3769230769230769
3885	Sc_chr04	1277450	1277739	289	0.356401384083045
3886	Sc_chr04	1277739	1277795	56	0.5178571428571428
3887	Sc_chr04	1277795	1277914	119	0.4453781512605042
3888	Sc_chr04	1277914	1277993	79	0.46835443037974683
3889	Sc_chr04	1277993	1278112	119	0.4453781512605042
3890	Sc_chr04	1278112	1278425	313	0.5175718849840255
3891	Sc_chr04	1278425	1278865	440	0.46590909090909094
3892	Sc_chr04	1278865	1278963	98	0.5204081632653061
3893	Sc_chr04	1278963	1279444	481	0.4303534303534303
3894	Sc_chr04	1279444	1279536	92	0.5108695652173914
3895	Sc_chr04	1279536	1279760	224	0.4642857142857143
3896	Sc_chr04	1279760	1279880	120	0.4666666666666666
3897	Sc_chr04	1279880	1280148	268	0.4626865671641791
3898	Sc_chr04	1280148	1280361	213	0.47417840375586856
3899	Sc_chr04	1280361	1281074	713	0.38008415147265073
3900	Sc_chr04	1281074	1281371	297	0.38047138047138046
3901	Sc_chr04	1281371	1281667	296	0.41891891891891897
3902	Sc_chr04	1281667	1281674	7	0.28571428571428575
3903	Sc_chr04	1281674	1281802	128	0.359375
3904	Sc_chr04	1281802	1282084	282	0.4219858156028369
3905	Sc_chr04	1282084	1282562	478	0.37656903765690375
3906	Sc_chr04	1282562	1282855	293	0.40273037542662116
3907	Sc_chr04	1282855	1283402	547	0.3820840950639854
3908	Sc_chr04	1283402	1283438	36	0.33333333333333337
3909	Sc_chr04	1283438	1284258	820	0.34024390243902436
3910	Sc_chr04	1284258	1284466	208	0.3605769230769231
3911	Sc_chr04	1284466	1285040	574	0.3257839721254356
3912	Sc_chr04	1285040	1285265	225	0.32888888888888884
3913	Sc_chr04	1285265	1285473	208	0.3365384615384615
3914	Sc_chr04	1285473	1285599	126	0.30952380952380953
3915	Sc_chr04	1285599	1285703	104	0.3173076923076923
3916	Sc_chr04	1285703	1285987	284	0.36971830985915494
3917	Sc_chr04	1285987	1286165	178	0.3258426966292135
3918	Sc_chr04	1286165	1286180	15	0.33333333333333337
3919	Sc_chr04	1286180	1286203	23	0.43478260869565216
3920	Sc_chr04	1286203	1286975	772	0.3795336787564767
3921	Sc_chr04	1286975	1287038	63	0.42857142857142855
3922	Sc_chr04	1287038	1287186	148	0.4324324324324324
3923	Sc_chr04	1287186	1287712	526	0.4049429657794677
3924	Sc_chr04	1287712	1288112	400	0.3825
3925	Sc_chr04	1288112	1288133	21	0.38095238095238093
3926	Sc_chr04	1288133	1288530	397	0.4508816120906801
3927	Sc_chr04	1288530	1288538	8	0.5
3928	Sc_chr04	1288538	1288617	79	0.5063291139240507
3929	Sc_chr04	1288617	1288802	185	0.48648648648648646
3930	Sc_chr04	1288802	1289636	834	0.3992805755395683
3931	Sc_chr04	1289636	1289677	41	0.36585365853658536
3932	Sc_chr04	1289677	1289711	34	0.32352941176470584
3933	Sc_chr04	1289711	1290120	409	0.43276283618581907
3934	Sc_chr04	1290120	1290343	223	0.3991031390134529
3935	Sc_chr04	1290343	1290809	466	0.38197424892703863
3936	Sc_chr04	1290809	1291073	264	0.22727272727272727
3937	Sc_chr04	1291073	1291151	78	0.33333333333333337
3938	Sc_chr04	1291151	1291247	96	0.39583333333333337
3939	Sc_chr04	1291247	1291520	273	0.41391941391941395
3940	Sc_chr04	1291520	1291530	10	0.7
3941	Sc_chr04	1291530	1291694	164	0.3963414634146341
3942	Sc_chr04	1291694	1291769	75	0.42666666666666664
3943	Sc_chr04	1291769	1292616	847	0.37544273907910275
3944	Sc_chr04	1292616	1292766	150	0.39333333333333337
3945	Sc_chr04	1292766	1293694	928	0.40086206896551724
3946	Sc_chr04	1293694	1293779	85	0.43529411764705883
3947	Sc_chr04	1293779	1293881	102	0.3431372549019608
3948	Sc_chr04	1293881	1293902	21	0.5238095238095238
3949	Sc_chr04	1293902	1294256	354	0.44067796610169496
3950	Sc_chr04	1294256	1294268	12	0.41666666666666663
3951	Sc_chr04	1294268	1294576	308	0.37662337662337664
3952	Sc_chr04	1294576	1295832	1256	0.37659235668789814
3953	Sc_chr04	1295832	1295838	6	0.5
3954	Sc_chr04	1295838	1295958	120	0.36666666666666664
3955	Sc_chr04	1295958	1295976	18	0.4444444444444444
3956	Sc_chr04	1295976	1296115	139	0.4028776978417266
3957	Sc_chr04	1296115	1296326	211	0.35545023696682465
3958	Sc_chr04	1296326	1296581	255	0.35294117647058826
3959	Sc_chr04	1296581	1297221	640	0.359375
3960	Sc_chr04	1297221	1297353	132	0.3939393939393939
3961	Sc_chr04	1297353	1297667	314	0.42038216560509556
3962	Sc_chr04	1297667	1297713	46	0.391304347826087
3963	Sc_chr04	1297713	1297806	93	0.3870967741935484
3964	Sc_chr04	1297806	1298875	1069	0.3601496725912067
3965	Sc_chr04	1298875	1299345	470	0.3468085106382979
3966	Sc_chr04	1299345	1299448	103	0.3786407766990291
3967	Sc_chr04	1299448	1299736	288	0.35763888888888884
3968	Sc_chr04	1299736	1299806	70	0.5
3969	Sc_chr04	1299806	1299877	71	0.38028169014084506
3970	Sc_chr04	1299877	1300176	299	0.34448160535117056
3971	Sc_chr04	1300176	1301271	1095	0.37168949771689497
3972	Sc_chr04	1301271	1301630	359	0.43732590529247906
3973	Sc_chr04	1301630	1301707	77	0.5064935064935066
3974	Sc_chr04	1301707	1302930	1223	0.3385118560915781
3975	Sc_chr04	1302930	1303317	387	0.3565891472868217
3976	Sc_chr04	1303317	1303439	122	0.4016393442622951
3977	Sc_chr04	1303439	1303498	59	0.3728813559322034
3978	Sc_chr04	1303498	1303512	14	0.5714285714285715
3979	Sc_chr04	1303512	1303539	27	0.4444444444444444
3980	Sc_chr04	1303539	1303611	72	0.4305555555555556
3981	Sc_chr04	1303611	1303854	243	0.39094650205761317
3982	Sc_chr04	1303854	1303859	5	0.4
3983	Sc_chr04	1303859	1303894	35	0.42857142857142855
3984	Sc_chr04	1303894	1304133	239	0.3598326359832636
3985	Sc_chr04	1304133	1304238	105	0.39047619047619053
3986	Sc_chr04	1304238	1304457	219	0.4292237442922374
3987	Sc_chr04	1304457	1304480	23	0.391304347826087
3988	Sc_chr04	1304480	1305206	726	0.35537190082644626
3989	Sc_chr04	1305206	1305248	42	0.40476190476190477
3990	Sc_chr04	1305248	1305391	143	0.24475524475524477
3991	Sc_chr04	1305391	1305421	30	0.4
3992	Sc_chr04	1305421	1306417	996	0.3393574297188755
3993	Sc_chr04	1306417	1307310	893	0.42777155655095184
3994	Sc_chr04	1307310	1308772	1462	0.4952120383036936
3995	Sc_chr04	1308772	1309222	450	0.40444444444444444
3996	Sc_chr04	1309222	1310528	1306	0.4035222052067381
3997	Sc_chr04	1310528	1310961	433	0.3833718244803695
3998	Sc_chr04	1310961	1311039	78	0.3205128205128205
3999	Sc_chr04	1311039	1311075	36	0.4722222222222222
4000	Sc_chr04	1311075	1311360	285	0.3859649122807018
4001	Sc_chr04	1311360	1311736	376	0.3776595744680851
4002	Sc_chr04	1311736	1311995	259	0.29343629343629346
4003	Sc_chr04	1311995	1312124	129	0.4418604651162791
4004	Sc_chr04	1312124	1312144	20	0.4
4005	Sc_chr04	1312144	1312837	693	0.41847041847041844
4006	Sc_chr04	1312837	1313116	279	0.3870967741935484
4007	Sc_chr04	1313116	1313348	232	0.4310344827586207
4008	Sc_chr04	1313348	1313688	340	0.3264705882352941
4009	Sc_chr04	1313688	1313761	73	0.3835616438356164
4010	Sc_chr04	1313761	1314059	298	0.3825503355704698
4011	Sc_chr04	1314059	1314152	93	0.3655913978494624
4012	Sc_chr04	1314152	1314613	461	0.37960954446854667
4013	Sc_chr04	1314613	1315334	721	0.34396671289875175
4014	Sc_chr04	1315334	1316072	738	0.3997289972899729
4015	Sc_chr04	1316072	1316212	140	0.37857142857142856
4016	Sc_chr04	1316212	1316258	46	0.4130434782608695
4017	Sc_chr04	1316258	1316622	364	0.3818681318681319
4018	Sc_chr04	1316622	1317313	691	0.38494934876989867
4019	Sc_chr04	1317313	1317322	9	0.4444444444444444
4020	Sc_chr04	1317322	1317415	93	0.5053763440860215
4021	Sc_chr04	1317415	1317559	144	0.4444444444444444
4022	Sc_chr04	1317559	1317685	126	0.4444444444444444
4023	Sc_chr04	1317685	1317745	60	0.36666666666666664
4024	Sc_chr04	1317745	1317989	244	0.36885245901639346
4025	Sc_chr04	1317989	1318186	197	0.37055837563451777
4026	Sc_chr04	1318186	1318357	171	0.43274853801169594
4027	Sc_chr04	1318357	1318620	263	0.4220532319391635
4028	Sc_chr04	1318620	1318908	288	0.4409722222222222
4029	Sc_chr04	1318908	1320120	1212	0.37788778877887785
4030	Sc_chr04	1320120	1320425	305	0.4721311475409836
4031	Sc_chr04	1320425	1320456	31	0.41935483870967744
4032	Sc_chr04	1320456	1321057	601	0.33943427620632277
4033	Sc_chr04	1321057	1321262	205	0.351219512195122
4034	Sc_chr04	1321262	1321549	287	0.32055749128919864
4035	Sc_chr04	1321549	1321696	147	0.3469387755102041
4036	Sc_chr04	1321696	1321706	10	0.3
4037	Sc_chr04	1321706	1321844	138	0.2971014492753623
4038	Sc_chr04	1321844	1321880	36	0.41666666666666663
4039	Sc_chr04	1321880	1322258	378	0.35185185185185186
4040	Sc_chr04	1322258	1322556	298	0.3087248322147651
4041	Sc_chr04	1322556	1323326	770	0.33766233766233766
4042	Sc_chr04	1323326	1323810	484	0.35743801652892565
4043	Sc_chr04	1323810	1323863	53	0.3962264150943396
4044	Sc_chr04	1323863	1324002	139	0.3597122302158273
4045	Sc_chr04	1324002	1324112	110	0.36363636363636365
4046	Sc_chr04	1324112	1324775	663	0.3574660633484163
4047	Sc_chr04	1324775	1325248	473	0.42283298097251587
4048	Sc_chr04	1325248	1325254	6	0.33333333333333337
4049	Sc_chr04	1325254	1325274	20	0.4
4050	Sc_chr04	1325274	1325326	52	0.44230769230769235
4051	Sc_chr04	1325326	1325450	124	0.3709677419354838
4052	Sc_chr04	1325450	1325841	391	0.42455242966751916
4053	Sc_chr04	1325841	1326071	230	0.4
4054	Sc_chr04	1326071	1326362	291	0.3642611683848797
4055	Sc_chr04	1326362	1326499	137	0.3868613138686131
4056	Sc_chr04	1326499	1326645	146	0.4178082191780822
4057	Sc_chr04	1326645	1327025	380	0.3368421052631579
4058	Sc_chr04	1327025	1327164	139	0.35251798561151076
4059	Sc_chr04	1327164	1327230	66	0.36363636363636365
4060	Sc_chr04	1327230	1327791	561	0.37076648841354726
4061	Sc_chr04	1327791	1327824	33	0.3939393939393939
4062	Sc_chr04	1327824	1327995	171	0.391812865497076
4063	Sc_chr04	1327995	1329246	1251	0.416466826538769
4064	Sc_chr04	1329246	1329424	178	0.42134831460674155
4065	Sc_chr04	1329424	1329623	199	0.37185929648241206
4066	Sc_chr04	1329623	1330010	387	0.5452196382428941
4067	Sc_chr04	1330010	1330236	226	0.27876106194690264
4068	Sc_chr04	1330236	1330644	408	0.31862745098039214
4069	Sc_chr04	1330644	1330741	97	0.38144329896907214
4070	Sc_chr04	1330741	1331677	936	0.34081196581196577
4071	Sc_chr04	1331677	1331794	117	0.3846153846153846
4072	Sc_chr04	1331794	1331978	184	0.32608695652173914
4073	Sc_chr04	1331978	1332004	26	0.4230769230769231
4074	Sc_chr04	1332004	1332022	18	0.33333333333333337
4075	Sc_chr04	1332022	1332523	501	0.36327345309381237
4076	Sc_chr04	1332523	1332952	429	0.34032634032634035
4077	Sc_chr04	1332952	1333058	106	0.330188679245283
4078	Sc_chr04	1333058	1333272	214	0.42523364485981313
4079	Sc_chr04	1333272	1333473	201	0.36318407960199006
4080	Sc_chr04	1333473	1334417	944	0.4353813559322034
4081	Sc_chr04	1334417	1334806	389	0.43958868894601544
4082	Sc_chr04	1334806	1334901	95	0.45263157894736844
4083	Sc_chr04	1334901	1335037	136	0.5367647058823529
4084	Sc_chr04	1335037	1335076	39	0.5641025641025641
4085	Sc_chr04	1335076	1335212	136	0.463235294117647
4086	Sc_chr04	1335212	1335487	275	0.45454545454545453
4087	Sc_chr04	1335487	1335565	78	0.4358974358974359
4088	Sc_chr04	1335565	1335952	387	0.4780361757105943
4089	Sc_chr04	1335952	1336200	248	0.40725806451612906
4090	Sc_chr04	1336200	1336272	72	0.38888888888888884
4091	Sc_chr04	1336272	1336611	339	0.40117994100294985
4092	Sc_chr04	1336611	1337708	1097	0.37283500455788515
4093	Sc_chr04	1337708	1337984	276	0.4311594202898551
4094	Sc_chr04	1337984	1338206	222	0.3783783783783784
4095	Sc_chr04	1338206	1338297	91	0.34065934065934067
4096	Sc_chr04	1338297	1338453	156	0.4294871794871795
4097	Sc_chr04	1338453	1340167	1714	0.3611435239206534
4098	Sc_chr04	1340167	1340195	28	0.4642857142857143
4099	Sc_chr04	1340195	1340210	15	0.4666666666666666
4100	Sc_chr04	1340210	1341331	1121	0.35236396074933096
4101	Sc_chr04	1341331	1341864	533	0.36397748592870544
4102	Sc_chr04	1341864	1342696	832	0.37980769230769235
4103	Sc_chr04	1342696	1343002	306	0.38888888888888884
4104	Sc_chr04	1343002	1343090	88	0.38636363636363635
4105	Sc_chr04	1343090	1343680	590	0.3508474576271186
4106	Sc_chr04	1343680	1344000	320	0.384375
4107	Sc_chr04	1344000	1344039	39	0.3076923076923077
4108	Sc_chr04	1344039	1344094	55	0.32727272727272727
4109	Sc_chr04	1344094	1344879	785	0.3987261146496815
4110	Sc_chr04	1344879	1345975	1096	0.4023722627737227
4111	Sc_chr04	1345975	1346134	159	0.45283018867924524
4112	Sc_chr04	1346134	1346513	379	0.3931398416886544
4113	Sc_chr04	1346513	1346685	172	0.4476744186046512
4114	Sc_chr04	1346685	1346779	94	0.36170212765957444
4115	Sc_chr04	1346779	1347223	444	0.3490990990990991
4116	Sc_chr04	1347223	1347322	99	0.3535353535353536
4117	Sc_chr04	1347322	1347826	504	0.375
4118	Sc_chr04	1347826	1347924	98	0.3469387755102041
4119	Sc_chr04	1347924	1347981	57	0.4736842105263158
4120	Sc_chr04	1347981	1348311	330	0.396969696969697
4121	Sc_chr04	1348311	1348628	317	0.35646687697160884
4122	Sc_chr04	1348628	1348767	139	0.3453237410071942
4123	Sc_chr04	1348767	1349067	300	0.39333333333333337
4124	Sc_chr04	1349067	1349463	396	0.40404040404040403
4125	Sc_chr04	1349463	1349721	258	0.3953488372093023
4126	Sc_chr04	1349721	1349781	60	0.38333333333333336
4127	Sc_chr04	1349781	1349823	42	0.42857142857142855
4128	Sc_chr04	1349823	1349860	37	0.35135135135135137
4129	Sc_chr04	1349860	1349950	90	0.41111111111111115
4130	Sc_chr04	1349950	1350081	131	0.3206106870229008
4131	Sc_chr04	1350081	1350280	199	0.38190954773869346
4132	Sc_chr04	1350280	1350465	185	0.3837837837837838
4133	Sc_chr04	1350465	1351912	1447	0.3959917069799585
4134	Sc_chr04	1351912	1352121	209	0.4019138755980861
4135	Sc_chr04	1352121	1352219	98	0.39795918367346933
4136	Sc_chr04	1352219	1352791	572	0.35489510489510484
4137	Sc_chr04	1352791	1353301	510	0.30980392156862746
4138	Sc_chr04	1353301	1353468	167	0.37724550898203596
4139	Sc_chr04	1353468	1353505	37	0.40540540540540543
4140	Sc_chr04	1353505	1353675	170	0.32352941176470584
4141	Sc_chr04	1353675	1354117	442	0.3574660633484163
4142	Sc_chr04	1354117	1354315	198	0.37373737373737376
4143	Sc_chr04	1354315	1354378	63	0.4603174603174603
4144	Sc_chr04	1354378	1354648	270	0.34444444444444444
4145	Sc_chr04	1354648	1354992	344	0.3372093023255814
4146	Sc_chr04	1354992	1355345	353	0.35977337110481583
4147	Sc_chr04	1355345	1357620	2275	0.3797802197802198
4148	Sc_chr04	1357620	1357755	135	0.2962962962962963
4149	Sc_chr04	1357755	1357839	84	0.30952380952380953
4150	Sc_chr04	1357839	1359012	1173	0.34953111679454385
4151	Sc_chr04	1359012	1359328	316	0.34177215189873417
4152	Sc_chr04	1359328	1359754	426	0.3732394366197183
4153	Sc_chr04	1359754	1360437	683	0.37481698389458273
4154	Sc_chr04	1360437	1361139	702	0.35042735042735046
4155	Sc_chr04	1361139	1361323	184	0.4619565217391305
4156	Sc_chr04	1361323	1362291	968	0.4142561983471074
4157	Sc_chr04	1362291	1362336	45	0.35555555555555557
4158	Sc_chr04	1362336	1362342	6	0.5
4159	Sc_chr04	1362342	1362535	193	0.40932642487046633
4160	Sc_chr04	1362535	1362765	230	0.4
4161	Sc_chr04	1362765	1362814	49	0.24489795918367346
4162	Sc_chr04	1362814	1363504	690	0.3927536231884058
4163	Sc_chr04	1363504	1363885	381	0.37270341207349084
4164	Sc_chr04	1363885	1364104	219	0.4018264840182648
4165	Sc_chr04	1364104	1364376	272	0.375
4166	Sc_chr04	1364376	1364529	153	0.3921568627450981
4167	Sc_chr04	1364529	1364812	283	0.3851590106007067
4168	Sc_chr04	1364812	1365469	657	0.3729071537290715
4169	Sc_chr04	1365469	1365838	369	0.3523035230352303
4170	Sc_chr04	1365838	1365931	93	0.5053763440860215
4171	Sc_chr04	1365931	1366027	96	0.40625
4172	Sc_chr04	1366027	1367550	1523	0.39001969796454367
4173	Sc_chr04	1367550	1367586	36	0.5
4174	Sc_chr04	1367586	1367619	33	0.5757575757575758
4175	Sc_chr04	1367619	1367696	77	0.37662337662337664
4176	Sc_chr04	1367696	1368126	430	0.35581395348837214
4177	Sc_chr04	1368126	1368374	248	0.38306451612903225
4178	Sc_chr04	1368374	1368496	122	0.3524590163934426
4179	Sc_chr04	1368496	1368503	7	0.42857142857142855
4180	Sc_chr04	1368503	1368715	212	0.339622641509434
4181	Sc_chr04	1368715	1369532	817	0.38188494492044067
4182	Sc_chr04	1369532	1369925	393	0.3511450381679389
4183	Sc_chr04	1369925	1369936	11	0.45454545454545453
4184	Sc_chr04	1369936	1370278	342	0.3567251461988304
4185	Sc_chr04	1370278	1370368	90	0.4222222222222222
4186	Sc_chr04	1370368	1370752	384	0.34114583333333337
4187	Sc_chr04	1370752	1371210	458	0.3733624454148472
4188	Sc_chr04	1371210	1371733	523	0.35946462715105165
4189	Sc_chr04	1371733	1371886	153	0.35947712418300654
4190	Sc_chr04	1371886	1372213	327	0.37003058103975534
4191	Sc_chr04	1372213	1372398	185	0.3621621621621622
4192	Sc_chr04	1372398	1372600	202	0.36138613861386143
4193	Sc_chr04	1372600	1372732	132	0.34090909090909094
4194	Sc_chr04	1372732	1372981	249	0.3453815261044177
4195	Sc_chr04	1372981	1373473	492	0.3434959349593496
4196	Sc_chr04	1373473	1373661	188	0.3670212765957446
4197	Sc_chr04	1373661	1373776	115	0.3652173913043478
4198	Sc_chr04	1373776	1373794	18	0.33333333333333337
4199	Sc_chr04	1373794	1374111	317	0.3785488958990536
4200	Sc_chr04	1374111	1374212	101	0.3564356435643565
4201	Sc_chr04	1374212	1374514	302	0.37086092715231783
4202	Sc_chr04	1374514	1374621	107	0.383177570093458
4203	Sc_chr04	1374621	1375048	427	0.39812646370023425
4204	Sc_chr04	1375048	1375243	195	0.35384615384615387
4205	Sc_chr04	1375243	1375423	180	0.38888888888888884
4206	Sc_chr04	1375423	1375470	47	0.425531914893617
4207	Sc_chr04	1375470	1376344	874	0.4153318077803203
4208	Sc_chr04	1376344	1376381	37	0.5675675675675675
4209	Sc_chr04	1376381	1376788	407	0.36609336609336607
4210	Sc_chr04	1376788	1376884	96	0.39583333333333337
4211	Sc_chr04	1376884	1377073	189	0.43386243386243384
4212	Sc_chr04	1377073	1377091	18	0.2777777777777778
4213	Sc_chr04	1377091	1377154	63	0.39682539682539686
4214	Sc_chr04	1377154	1377316	162	0.3148148148148148
4215	Sc_chr04	1377316	1377757	441	0.36054421768707484
4216	Sc_chr04	1377757	1377975	218	0.34862385321100914
4217	Sc_chr04	1377975	1378018	43	0.37209302325581395
4218	Sc_chr04	1378018	1378224	206	0.3737864077669903
4219	Sc_chr04	1378224	1378921	697	0.37302725968436157
4220	Sc_chr04	1378921	1379179	258	0.32558139534883723
4221	Sc_chr04	1379179	1379327	148	0.3716216216216216
4222	Sc_chr04	1379327	1379594	267	0.4082397003745319
4223	Sc_chr04	1379594	1380052	458	0.2816593886462882
4224	Sc_chr04	1380052	1380081	29	0.3793103448275862
4225	Sc_chr04	1380081	1380587	506	0.3102766798418972
4226	Sc_chr04	1380587	1381409	822	0.3686131386861314
4227	Sc_chr04	1381409	1381651	242	0.37603305785123964
4228	Sc_chr04	1381651	1381826	175	0.3257142857142857
4229	Sc_chr04	1381826	1382024	198	0.45959595959595956
4230	Sc_chr04	1382024	1382039	15	0.4
4231	Sc_chr04	1382039	1382182	143	0.3146853146853147
4232	Sc_chr04	1382182	1382329	147	0.28571428571428575
4233	Sc_chr04	1382329	1382601	272	0.400735294117647
4234	Sc_chr04	1382601	1382974	373	0.34584450402144773
4235	Sc_chr04	1382974	1383073	99	0.45454545454545453
4236	Sc_chr04	1383073	1383170	97	0.44329896907216493
4237	Sc_chr04	1383170	1383851	681	0.4052863436123348
4238	Sc_chr04	1383851	1383864	13	0.3846153846153846
4239	Sc_chr04	1383864	1383920	56	0.4107142857142857
4240	Sc_chr04	1383920	1383939	19	0.4736842105263158
4241	Sc_chr04	1383939	1384170	231	0.367965367965368
4242	Sc_chr04	1384170	1384178	8	0.625
4243	Sc_chr04	1384178	1384659	481	0.3908523908523909
4244	Sc_chr04	1384659	1384859	200	0.39
4245	Sc_chr04	1384859	1385119	260	0.3346153846153846
4246	Sc_chr04	1385119	1385572	453	0.36203090507726265
4247	Sc_chr04	1385572	1385696	124	0.49193548387096775
4248	Sc_chr04	1385696	1386370	674	0.4347181008902077
4249	Sc_chr04	1386370	1386561	191	0.47643979057591623
4250	Sc_chr04	1386561	1386923	362	0.3784530386740332
4251	Sc_chr04	1386923	1387060	137	0.3868613138686131
4252	Sc_chr04	1387060	1387105	45	0.4888888888888889
4253	Sc_chr04	1387105	1387164	59	0.423728813559322
4254	Sc_chr04	1387164	1387412	248	0.4637096774193548
4255	Sc_chr04	1387412	1387650	238	0.4327731092436975
4256	Sc_chr04	1387650	1387669	19	0.3157894736842105
4257	Sc_chr04	1387669	1387911	242	0.36363636363636365
4258	Sc_chr04	1387911	1388598	687	0.34643377001455605
4259	Sc_chr04	1388598	1389196	598	0.34448160535117056
4260	Sc_chr04	1389196	1390419	1223	0.3851185609157809
4261	Sc_chr04	1390419	1390921	502	0.40039840637450197
4262	Sc_chr04	1390921	1391157	236	0.4067796610169491
4263	Sc_chr04	1391157	1391751	594	0.4225589225589226
4264	Sc_chr04	1391751	1392036	285	0.41754385964912283
4265	Sc_chr04	1392036	1392929	893	0.3919372900335947
4266	Sc_chr04	1392929	1392975	46	0.32608695652173914
4267	Sc_chr04	1392975	1393470	495	0.3515151515151515
4268	Sc_chr04	1393470	1393507	37	0.2972972972972973
4269	Sc_chr04	1393507	1393812	305	0.36721311475409835
4270	Sc_chr04	1393812	1393839	27	0.3703703703703704
4271	Sc_chr04	1393839	1393865	26	0.5
4272	Sc_chr04	1393865	1394341	476	0.41596638655462187
4273	Sc_chr04	1394341	1394891	550	0.39090909090909093
4274	Sc_chr04	1394891	1396712	1821	0.3970345963756178
4275	Sc_chr04	1396712	1396851	139	0.3381294964028777
4276	Sc_chr04	1396851	1397542	691	0.37481910274963826
4277	Sc_chr04	1397542	1397687	145	0.4344827586206897
4278	Sc_chr04	1397687	1397881	194	0.36597938144329895
4279	Sc_chr04	1397881	1398423	542	0.3634686346863469
4280	Sc_chr04	1398423	1398591	168	0.35714285714285715
4281	Sc_chr04	1398591	1398681	90	0.41111111111111115
4282	Sc_chr04	1398681	1398713	32	0.3125
4283	Sc_chr04	1398713	1398951	238	0.31092436974789917
4284	Sc_chr04	1398951	1399455	504	0.36507936507936506
4285	Sc_chr04	1399455	1399914	459	0.33986928104575165
4286	Sc_chr04	1399914	1400499	585	0.3572649572649573
4287	Sc_chr04	1400499	1400586	87	0.3908045977011494
4288	Sc_chr04	1400586	1400632	46	0.5217391304347826
4289	Sc_chr04	1400632	1401093	461	0.3882863340563991
4290	Sc_chr04	1401093	1401153	60	0.48333333333333334
4291	Sc_chr04	1401153	1402005	852	0.386150234741784
4292	Sc_chr04	1402005	1402224	219	0.32876712328767127
4293	Sc_chr04	1402224	1402778	554	0.37906137184115524
4294	Sc_chr04	1402778	1403837	1059	0.3635505193578848
4295	Sc_chr04	1403837	1404121	284	0.397887323943662
4296	Sc_chr04	1404121	1404512	391	0.309462915601023
4297	Sc_chr04	1404512	1405001	489	0.3537832310838446
4298	Sc_chr04	1405001	1405179	178	0.35955056179775285
4299	Sc_chr04	1405179	1405628	449	0.3674832962138085
4300	Sc_chr04	1405628	1405637	9	0.5555555555555556
4301	Sc_chr04	1405637	1405874	237	0.379746835443038
4302	Sc_chr04	1405874	1405960	86	0.3372093023255814
4303	Sc_chr04	1405960	1405971	11	0.6363636363636364
4304	Sc_chr04	1405971	1407103	1132	0.33745583038869253
4305	Sc_chr04	1407103	1407542	439	0.3530751708428246
4306	Sc_chr04	1407542	1407777	235	0.4042553191489362
4307	Sc_chr04	1407777	1407923	146	0.48630136986301375
4308	Sc_chr04	1407923	1408010	87	0.4367816091954023
4309	Sc_chr04	1408010	1408028	18	0.38888888888888884
4310	Sc_chr04	1408028	1408290	262	0.41221374045801523
4311	Sc_chr04	1408290	1408852	562	0.3879003558718861
4312	Sc_chr04	1408852	1408878	26	0.5
4313	Sc_chr04	1408878	1408914	36	0.3055555555555556
4314	Sc_chr04	1408914	1409039	125	0.4
4315	Sc_chr04	1409039	1409045	6	0.5
4316	Sc_chr04	1409045	1409051	6	0.5
4317	Sc_chr04	1409051	1409057	6	0.5
4318	Sc_chr04	1409057	1409063	6	0.5
4319	Sc_chr04	1409063	1409478	415	0.43614457831325304
4320	Sc_chr04	1409478	1409500	22	0.2727272727272727
4321	Sc_chr04	1409500	1409794	294	0.43537414965986393
4322	Sc_chr04	1409794	1409849	55	0.45454545454545453
4323	Sc_chr04	1409849	1410078	229	0.47161572052401746
4324	Sc_chr04	1410078	1410655	577	0.4367417677642981
4325	Sc_chr04	1410655	1410773	118	0.5677966101694916
4326	Sc_chr04	1410773	1410815	42	0.4761904761904762
4327	Sc_chr04	1410815	1411004	189	0.4973544973544973
4328	Sc_chr04	1411004	1411786	782	0.43478260869565216
4329	Sc_chr04	1411786	1412851	1065	0.40187793427230045
4330	Sc_chr04	1412851	1412900	49	0.46938775510204084
4331	Sc_chr04	1412900	1413547	647	0.3987635239567233
4332	Sc_chr04	1413547	1413659	112	0.4107142857142857
4333	Sc_chr04	1413659	1413743	84	0.4523809523809524
4334	Sc_chr04	1413743	1413799	56	0.35714285714285715
4335	Sc_chr04	1413799	1413900	101	0.39603960396039606
4336	Sc_chr04	1413900	1414564	664	0.3117469879518072
4337	Sc_chr04	1414564	1414972	408	0.3946078431372549
4338	Sc_chr04	1414972	1415052	80	0.4625
4339	Sc_chr04	1415052	1415601	549	0.389799635701275
4340	Sc_chr04	1415601	1415791	190	0.4
4341	Sc_chr04	1415791	1415800	9	0.33333333333333337
4342	Sc_chr04	1415800	1416511	711	0.360056258790436
4343	Sc_chr04	1416511	1416720	209	0.46411483253588515
4344	Sc_chr04	1416720	1416812	92	0.40217391304347827
4345	Sc_chr04	1416812	1416941	129	0.40310077519379844
4346	Sc_chr04	1416941	1417266	325	0.37230769230769234
4347	Sc_chr04	1417266	1417458	192	0.3072916666666667
4348	Sc_chr04	1417458	1417544	86	0.4302325581395349
4349	Sc_chr04	1417544	1417614	70	0.34285714285714286
4350	Sc_chr04	1417614	1417759	145	0.4206896551724138
4351	Sc_chr04	1417759	1418068	309	0.4401294498381877
4352	Sc_chr04	1418068	1418246	178	0.42134831460674155
4353	Sc_chr04	1418246	1418547	301	0.32558139534883723
4354	Sc_chr04	1418547	1418945	398	0.3894472361809045
4355	Sc_chr04	1418945	1419130	185	0.4216216216216216
4356	Sc_chr04	1419130	1419238	108	0.4722222222222222
4357	Sc_chr04	1419238	1419259	21	0.4761904761904762
4358	Sc_chr04	1419259	1419676	417	0.44124700239808157
4359	Sc_chr04	1419676	1419817	141	0.48936170212765956
4360	Sc_chr04	1419817	1419990	173	0.4797687861271676
4361	Sc_chr04	1419990	1420155	165	0.4303030303030303
4362	Sc_chr04	1420155	1420166	11	0.45454545454545453
4363	Sc_chr04	1420166	1420200	34	0.5
4364	Sc_chr04	1420200	1420700	500	0.456
4365	Sc_chr04	1420700	1420770	70	0.5142857142857143
4366	Sc_chr04	1420770	1421301	531	0.4067796610169491
4367	Sc_chr04	1421301	1421455	154	0.461038961038961
4368	Sc_chr04	1421455	1422004	549	0.3825136612021858
4369	Sc_chr04	1422004	1422200	196	0.3826530612244898
4370	Sc_chr04	1422200	1422852	652	0.34662576687116564
4371	Sc_chr04	1422852	1422906	54	0.2962962962962963
4372	Sc_chr04	1422906	1423181	275	0.32
4373	Sc_chr04	1423181	1423263	82	0.3048780487804878
4374	Sc_chr04	1423263	1424030	767	0.3194263363754889
4375	Sc_chr04	1424030	1424371	341	0.36950146627565983
4376	Sc_chr04	1424371	1424744	373	0.3190348525469169
4377	Sc_chr04	1424744	1424911	167	0.34131736526946105
4378	Sc_chr04	1424911	1424980	69	0.43478260869565216
4379	Sc_chr04	1424980	1425043	63	0.39682539682539686
4380	Sc_chr04	1425043	1425229	186	0.3387096774193548
4381	Sc_chr04	1425229	1425358	129	0.4418604651162791
4382	Sc_chr04	1425358	1425704	346	0.39306358381502887
4383	Sc_chr04	1425704	1426291	587	0.3901192504258944
4384	Sc_chr04	1426291	1426617	326	0.3834355828220859
4385	Sc_chr04	1426617	1426686	69	0.36231884057971014
4386	Sc_chr04	1426686	1427142	456	0.3859649122807018
4387	Sc_chr04	1427142	1427793	651	0.3824884792626728
4388	Sc_chr04	1427793	1427944	151	0.34437086092715236
4389	Sc_chr04	1427944	1428077	133	0.39097744360902253
4390	Sc_chr04	1428077	1428389	312	0.3173076923076923
4391	Sc_chr04	1428389	1428886	497	0.4647887323943662
4392	Sc_chr04	1428886	1428961	75	0.38666666666666666
4393	Sc_chr04	1428961	1429589	628	0.4713375796178344
4394	Sc_chr04	1429589	1429822	233	0.4892703862660944
4395	Sc_chr04	1429822	1429958	136	0.44852941176470584
4396	Sc_chr04	1429958	1430024	66	0.48484848484848486
4397	Sc_chr04	1430024	1430039	15	0.5333333333333333
4398	Sc_chr04	1430039	1430536	497	0.4929577464788732
4399	Sc_chr04	1430536	1431079	543	0.425414364640884
4400	Sc_chr04	1431079	1431514	435	0.37471264367816093
4401	Sc_chr04	1431514	1431574	60	0.36666666666666664
4402	Sc_chr04	1431574	1431737	163	0.4049079754601227
4403	Sc_chr04	1431737	1431860	123	0.4065040650406504
4404	Sc_chr04	1431860	1432010	150	0.36
4405	Sc_chr04	1432010	1432043	33	0.36363636363636365
4406	Sc_chr04	1432043	1432353	310	0.4032258064516129
4407	Sc_chr04	1432353	1432776	423	0.4184397163120568
4408	Sc_chr04	1432776	1432796	20	0.5
4409	Sc_chr04	1432796	1432882	86	0.4302325581395349
4410	Sc_chr04	1432882	1433113	231	0.4588744588744589
4411	Sc_chr04	1433113	1433142	29	0.3448275862068966
4412	Sc_chr04	1433142	1433569	427	0.3817330210772834
4413	Sc_chr04	1433569	1433609	40	0.45
4414	Sc_chr04	1433609	1433782	173	0.42196531791907516
4415	Sc_chr04	1433782	1433864	82	0.40243902439024387
4416	Sc_chr04	1433864	1434018	154	0.48701298701298706
4417	Sc_chr04	1434018	1435426	1408	0.4133522727272727
4418	Sc_chr04	1435426	1435996	570	0.3631578947368421
4419	Sc_chr04	1435996	1436348	352	0.3806818181818182
4420	Sc_chr04	1436348	1436369	21	0.4761904761904762
4421	Sc_chr04	1436369	1437653	1284	0.38239875389408096
4422	Sc_chr04	1437653	1437728	75	0.4
4423	Sc_chr04	1437728	1438285	557	0.33213644524236985
4424	Sc_chr04	1438285	1438543	258	0.3062015503875969
4425	Sc_chr04	1438543	1438995	452	0.32300884955752207
4426	Sc_chr04	1438995	1439446	451	0.29933481152993346
4427	Sc_chr04	1439446	1439547	101	0.33663366336633666
4428	Sc_chr04	1439547	1439649	102	0.30392156862745096
4429	Sc_chr04	1439649	1439927	278	0.302158273381295
4430	Sc_chr04	1439927	1440131	204	0.3921568627450981
4431	Sc_chr04	1440131	1440657	526	0.34030418250950567
4432	Sc_chr04	1440657	1441364	707	0.36067892503536064
4433	Sc_chr04	1441364	1441539	175	0.3028571428571428
4434	Sc_chr04	1441539	1442001	462	0.3463203463203463
4435	Sc_chr04	1442001	1442245	244	0.3442622950819672
4436	Sc_chr04	1442245	1442386	141	0.39716312056737585
4437	Sc_chr04	1442386	1442850	464	0.35775862068965514
4438	Sc_chr04	1442850	1442913	63	0.36507936507936506
4439	Sc_chr04	1442913	1444126	1213	0.3676834295136026
4440	Sc_chr04	1444126	1444450	324	0.4074074074074074
4441	Sc_chr04	1444450	1444831	381	0.42782152230971127
4442	Sc_chr04	1444831	1444870	39	0.4358974358974359
4443	Sc_chr04	1444870	1444903	33	0.5454545454545454
4444	Sc_chr04	1444903	1445115	212	0.46226415094339623
4445	Sc_chr04	1445115	1445125	10	0.6
4446	Sc_chr04	1445125	1445131	6	0.5
4447	Sc_chr04	1445131	1445239	108	0.42592592592592593
4448	Sc_chr04	1445239	1445863	624	0.4118589743589744
4449	Sc_chr04	1445863	1446687	824	0.44417475728155337
4450	Sc_chr04	1446687	1447037	350	0.37142857142857144
4451	Sc_chr04	1447037	1447042	5	0.6
4452	Sc_chr04	1447042	1447309	267	0.33333333333333337
4453	Sc_chr04	1447309	1448671	1362	0.36196769456681355
4454	Sc_chr04	1448671	1448936	265	0.3169811320754717
4455	Sc_chr04	1448936	1449146	210	0.30952380952380953
4456	Sc_chr04	1449146	1449511	365	0.336986301369863
4457	Sc_chr04	1449511	1449812	301	0.40863787375415284
4458	Sc_chr04	1449812	1449842	30	0.4
4459	Sc_chr04	1449842	1449857	15	0.4
4460	Sc_chr04	1449857	1450019	162	0.3395061728395062
4461	Sc_chr04	1450019	1450327	308	0.35714285714285715
4462	Sc_chr04	1450327	1451643	1316	0.36930091185410335
4463	Sc_chr04	1451643	1452209	566	0.39752650176678445
4464	Sc_chr04	1452209	1453085	876	0.3595890410958904
4465	Sc_chr04	1453085	1453231	146	0.32876712328767127
4466	Sc_chr04	1453231	1453623	392	0.3698979591836735
4467	Sc_chr04	1453623	1454349	726	0.43250688705234164
4468	Sc_chr04	1454349	1454645	296	0.35135135135135137
4469	Sc_chr04	1454645	1454869	224	0.39732142857142855
4470	Sc_chr04	1454869	1454999	130	0.3384615384615385
4471	Sc_chr04	1454999	1455169	170	0.388235294117647
4472	Sc_chr04	1455169	1455860	691	0.4037626628075253
4473	Sc_chr04	1455860	1456277	417	0.3213429256594724
4474	Sc_chr04	1456277	1456688	411	0.26277372262773724
4475	Sc_chr04	1456688	1457722	1034	0.32495164410058025
4476	Sc_chr04	1457722	1458510	788	0.3972081218274111
4477	Sc_chr04	1458510	1459054	544	0.4099264705882353
4478	Sc_chr04	1459054	1459484	430	0.34651162790697676
4479	Sc_chr04	1459484	1460380	896	0.45089285714285715
4480	Sc_chr04	1460380	1460829	449	0.37639198218262804
4481	Sc_chr04	1460829	1460845	16	0.375
4482	Sc_chr04	1460845	1461148	303	0.3729372937293729
4483	Sc_chr04	1461148	1461669	521	0.37811900191938574
4484	Sc_chr04	1461669	1462749	1080	0.3287037037037037
4485	Sc_chr04	1462749	1462761	12	0.25
4486	Sc_chr04	1462761	1462860	99	0.3838383838383838
4487	Sc_chr04	1462860	1463041	181	0.4088397790055249
4488	Sc_chr04	1463041	1463081	40	0.4
4489	Sc_chr04	1463081	1463094	13	0.3076923076923077
4490	Sc_chr04	1463094	1463419	325	0.37846153846153846
4491	Sc_chr04	1463419	1463506	87	0.4942528735632184
4492	Sc_chr04	1463506	1463645	139	0.33093525179856115
4493	Sc_chr04	1463645	1463757	112	0.36607142857142855
4494	Sc_chr04	1463757	1463876	119	0.37815126050420167
4495	Sc_chr04	1463876	1463931	55	0.3818181818181818
4496	Sc_chr04	1463931	1463985	54	0.3148148148148148
4497	Sc_chr04	1463985	1464296	311	0.3665594855305466
4498	Sc_chr04	1464296	1464305	9	0.33333333333333337
4499	Sc_chr04	1464305	1464774	469	0.3667377398720682
4500	Sc_chr04	1464774	1464966	192	0.33333333333333337
4501	Sc_chr04	1464966	1465126	160	0.38125
4502	Sc_chr04	1465126	1465208	82	0.45121951219512196
4503	Sc_chr04	1465208	1465290	82	0.4146341463414634
4504	Sc_chr04	1465290	1465317	27	0.2592592592592593
4505	Sc_chr04	1465317	1465667	350	0.40857142857142853
4506	Sc_chr04	1465667	1465827	160	0.40625
4507	Sc_chr04	1465827	1467225	1398	0.38197424892703863
4508	Sc_chr04	1467225	1467459	234	0.46581196581196577
4509	Sc_chr04	1467459	1467892	433	0.3787528868360277
4510	Sc_chr04	1467892	1468954	1062	0.39736346516007537
4511	Sc_chr04	1468954	1469167	213	0.4178403755868545
4512	Sc_chr04	1469167	1469490	323	0.4303405572755418
4513	Sc_chr04	1469490	1469500	10	0.4
4514	Sc_chr04	1469500	1469512	12	0.33333333333333337
4515	Sc_chr04	1469512	1469621	109	0.4128440366972477
4516	Sc_chr04	1469621	1470576	955	0.3968586387434555
4517	Sc_chr04	1470576	1470726	150	0.39333333333333337
4518	Sc_chr04	1470726	1470879	153	0.411764705882353
4519	Sc_chr04	1470879	1471151	272	0.39705882352941174
4520	Sc_chr04	1471151	1471624	473	0.37632135306553915
4521	Sc_chr04	1471624	1472323	699	0.3919885550786838
4522	Sc_chr04	1472323	1473099	776	0.37371134020618557
4523	Sc_chr04	1473099	1473139	40	0.35
4524	Sc_chr04	1473139	1474311	1172	0.33532423208191126
4525	Sc_chr04	1474311	1475094	783	0.3282247765006386
4526	Sc_chr04	1475094	1475407	313	0.41533546325878595
4527	Sc_chr04	1475407	1476281	874	0.4439359267734554
4528	Sc_chr04	1476281	1476413	132	0.4621212121212121
4529	Sc_chr04	1476413	1476680	267	0.36704119850187267
4530	Sc_chr04	1476680	1477140	460	0.4847826086956522
4531	Sc_chr04	1477140	1477514	374	0.4652406417112299
4532	Sc_chr04	1477514	1477941	427	0.4964871194379391
4533	Sc_chr04	1477941	1477958	17	0.411764705882353
4534	Sc_chr04	1477958	1478701	743	0.42530282637954236
4535	Sc_chr04	1478701	1478804	103	0.3786407766990291
4536	Sc_chr04	1478804	1478987	183	0.4043715846994535
4537	Sc_chr04	1478987	1479342	355	0.38591549295774646
4538	Sc_chr04	1479342	1479426	84	0.38095238095238093
4539	Sc_chr04	1479426	1479560	134	0.3507462686567164
4540	Sc_chr04	1479560	1479647	87	0.3563218390804597
4541	Sc_chr04	1479647	1479905	258	0.3682170542635659
4542	Sc_chr04	1479905	1480578	673	0.35661218424962854
4543	Sc_chr04	1480578	1480676	98	0.39795918367346933
4544	Sc_chr04	1480676	1482100	1424	0.36025280898876405
4545	Sc_chr04	1482100	1482489	389	0.3496143958868895
4546	Sc_chr04	1482489	1482917	428	0.37616822429906543
4547	Sc_chr04	1482917	1483031	114	0.35964912280701755
4548	Sc_chr04	1483031	1483299	268	0.3805970149253731
4549	Sc_chr04	1483299	1483571	272	0.35661764705882354
4550	Sc_chr04	1483571	1484046	475	0.3305263157894737
4551	Sc_chr04	1484046	1484652	606	0.3531353135313531
4552	Sc_chr04	1484652	1484846	194	0.31958762886597936
4553	Sc_chr04	1484846	1484876	30	0.4
4554	Sc_chr04	1484876	1484887	11	0.2727272727272727
4555	Sc_chr04	1484887	1485063	176	0.34659090909090906
4556	Sc_chr04	1485063	1485098	35	0.34285714285714286
4557	Sc_chr04	1485098	1485384	286	0.32167832167832167
4558	Sc_chr04	1485384	1485604	220	0.25
4559	Sc_chr04	1485604	1485711	107	0.3551401869158879
4560	Sc_chr04	1485711	1486182	471	0.35881104033970274
4561	Sc_chr04	1486182	1486260	78	0.33333333333333337
4562	Sc_chr04	1486260	1486374	114	0.4035087719298246
4563	Sc_chr04	1486374	1486739	365	0.40273972602739727
4564	Sc_chr04	1486739	1487755	1016	0.3346456692913386
4565	Sc_chr04	1487755	1487975	220	0.32727272727272727
4566	Sc_chr04	1487975	1488163	188	0.35106382978723405
4567	Sc_chr04	1488163	1488313	150	0.32
4568	Sc_chr04	1488313	1488343	30	0.36666666666666664
4569	Sc_chr04	1488343	1488809	466	0.38412017167381973
4570	Sc_chr04	1488809	1489409	600	0.30833333333333335
4571	Sc_chr04	1489409	1489681	272	0.36397058823529416
4572	Sc_chr04	1489681	1490305	624	0.4375
4573	Sc_chr04	1490305	1490502	197	0.5380710659898478
4574	Sc_chr04	1490502	1490512	10	0.3
4575	Sc_chr04	1490512	1490516	4	0.5
4576	Sc_chr04	1490516	1490682	166	0.3734939759036145
4577	Sc_chr04	1490682	1490732	50	0.36
4578	Sc_chr04	1490732	1490750	18	0.4444444444444444
4579	Sc_chr04	1490750	1491399	649	0.386748844375963
4580	Sc_chr04	1491399	1491417	18	0.2777777777777778
4581	Sc_chr04	1491417	1491549	132	0.41666666666666663
4582	Sc_chr04	1491549	1491735	186	0.3978494623655914
4583	Sc_chr04	1491735	1491828	93	0.27956989247311825
4584	Sc_chr04	1491828	1492096	268	0.41417910447761197
4585	Sc_chr04	1492096	1492247	151	0.40397350993377484
4586	Sc_chr04	1492247	1492548	301	0.36544850498338866
4587	Sc_chr04	1492548	1492904	356	0.34831460674157305
4588	Sc_chr04	1492904	1492998	94	0.3404255319148936
4589	Sc_chr04	1492998	1493295	297	0.3602693602693603
4590	Sc_chr04	1493295	1493397	102	0.3921568627450981
4591	Sc_chr04	1493397	1494664	1267	0.3559589581689029
4592	Sc_chr04	1494664	1494949	285	0.3964912280701754
4593	Sc_chr04	1494949	1495251	302	0.3741721854304636
4594	Sc_chr04	1495251	1495705	454	0.3876651982378855
4595	Sc_chr04	1495705	1496266	561	0.3137254901960784
4596	Sc_chr04	1496266	1496738	472	0.40889830508474573
4597	Sc_chr04	1496738	1496870	132	0.4318181818181818
4598	Sc_chr04	1496870	1496913	43	0.3953488372093023
4599	Sc_chr04	1496913	1496977	64	0.484375
4600	Sc_chr04	1496977	1496994	17	0.411764705882353
4601	Sc_chr04	1496994	1497113	119	0.411764705882353
4602	Sc_chr04	1497113	1497128	15	0.4666666666666666
4603	Sc_chr04	1497128	1497218	90	0.4777777777777778
4604	Sc_chr04	1497218	1497276	58	0.3793103448275862
4605	Sc_chr04	1497276	1497293	17	0.411764705882353
4606	Sc_chr04	1497293	1497430	137	0.437956204379562
4607	Sc_chr04	1497430	1497527	97	0.422680412371134
4608	Sc_chr04	1497527	1497662	135	0.4888888888888889
4609	Sc_chr04	1497662	1497883	221	0.3755656108597285
4610	Sc_chr04	1497883	1497971	88	0.38636363636363635
4611	Sc_chr04	1497971	1498157	186	0.3763440860215054
4612	Sc_chr04	1498157	1498615	458	0.3580786026200873
4613	Sc_chr04	1498615	1498822	207	0.4444444444444444
4614	Sc_chr04	1498822	1499162	340	0.3264705882352941
4615	Sc_chr04	1499162	1499231	69	0.3768115942028985
4616	Sc_chr04	1499231	1500659	1428	0.334733893557423
4617	Sc_chr04	1500659	1500920	261	0.31800766283524906
4618	Sc_chr04	1500920	1501468	548	0.35401459854014594
4619	Sc_chr04	1501468	1501689	221	0.4343891402714932
4620	Sc_chr04	1501689	1502469	780	0.3782051282051282
4621	Sc_chr04	1502469	1502569	100	0.41
4622	Sc_chr04	1502569	1502919	350	0.3257142857142857
4623	Sc_chr04	1502919	1503272	353	0.28895184135977336
4624	Sc_chr04	1503272	1504208	936	0.46047008547008544
4625	Sc_chr04	1504208	1505335	1127	0.4445430346051464
4626	Sc_chr04	1505335	1505430	95	0.3157894736842105
4627	Sc_chr04	1505430	1505560	130	0.2923076923076923
4628	Sc_chr04	1505560	1505609	49	0.3469387755102041
4629	Sc_chr04	1505609	1505993	384	0.3046875
4630	Sc_chr04	1505993	1506198	205	0.3463414634146341
4631	Sc_chr04	1506198	1506372	174	0.3850574712643678
4632	Sc_chr04	1506372	1506409	37	0.2972972972972973
4633	Sc_chr04	1506409	1506823	414	0.4106280193236715
4634	Sc_chr04	1506823	1507703	880	0.43977272727272726
4635	Sc_chr04	1507703	1508211	508	0.3720472440944882
4636	Sc_chr04	1508211	1508751	540	0.43333333333333335
4637	Sc_chr04	1508751	1508993	242	0.37603305785123964
4638	Sc_chr04	1508993	1509546	553	0.39421338155515373
4639	Sc_chr04	1509546	1509844	298	0.3422818791946309
4640	Sc_chr04	1509844	1511280	1436	0.38788300835654593
4641	Sc_chr04	1511280	1511563	283	0.40636042402826855
4642	Sc_chr04	1511563	1512183	620	0.3354838709677419
4643	Sc_chr04	1512183	1512276	93	0.4301075268817204
4644	Sc_chr04	1512276	1512330	54	0.4444444444444444
4645	Sc_chr04	1512330	1513380	1050	0.4161904761904762
4646	Sc_chr04	1513380	1513864	484	0.3367768595041322
4647	Sc_chr04	1513864	1515060	1196	0.31438127090301005
4648	Sc_chr04	1515060	1515389	329	0.3586626139817629
4649	Sc_chr04	1515389	1515455	66	0.2878787878787879
4650	Sc_chr04	1515455	1515487	32	0.375
4651	Sc_chr04	1515487	1516686	1199	0.359466221851543
4652	Sc_chr04	1516686	1516783	97	0.3298969072164948
4653	Sc_chr04	1516783	1516861	78	0.3076923076923077
4654	Sc_chr04	1516861	1517237	376	0.3111702127659574
4655	Sc_chr04	1517237	1517810	573	0.33158813263525305
4656	Sc_chr04	1517810	1518703	893	0.35274356103023513
4657	Sc_chr04	1518703	1518867	164	0.3048780487804878
4658	Sc_chr04	1518867	1519240	373	0.3297587131367293
4659	Sc_chr04	1519240	1519247	7	0.42857142857142855
4660	Sc_chr04	1519247	1519369	122	0.27049180327868855
4661	Sc_chr04	1519369	1519381	12	0.41666666666666663
4662	Sc_chr04	1519381	1519794	413	0.34624697336561744
4663	Sc_chr04	1519794	1520032	238	0.40336134453781514
4664	Sc_chr04	1520032	1520136	104	0.375
4665	Sc_chr04	1520136	1520274	138	0.427536231884058
4666	Sc_chr04	1520274	1520594	320	0.371875
4667	Sc_chr04	1520594	1521037	443	0.35440180586907455
4668	Sc_chr04	1521037	1521781	744	0.35618279569892475
4669	Sc_chr04	1521781	1522933	1152	0.3706597222222222
4670	Sc_chr04	1522933	1523079	146	0.3972602739726028
4671	Sc_chr04	1523079	1523520	441	0.4648526077097506
4672	Sc_chr04	1523520	1523752	232	0.33189655172413796
4673	Sc_chr04	1523752	1524007	255	0.37254901960784315
4674	Sc_chr04	1524007	1524056	49	0.46938775510204084
4675	Sc_chr04	1524056	1525085	1029	0.36929057337220605
4676	Sc_chr04	1525085	1525603	518	0.48648648648648646
4677	Sc_chr04	1525603	1526433	830	0.38795180722891565
4678	Sc_chr04	1526433	1527022	589	0.4227504244482173
4679	Sc_chr04	1527022	1527184	162	0.45679012345679015
4680	Sc_chr04	1527184	1527188	4	0.5
4681	Sc_chr04	1527188	1527390	202	0.42574257425742573
4682	Sc_chr04	1527390	1528081	691	0.42547033285094066
4683	Sc_chr04	1528081	1528111	30	0.5
4684	Sc_chr04	1528111	1528117	6	0.5
4685	Sc_chr04	1528117	1528567	450	0.4822222222222222
4686	Sc_chr04	1528567	1528573	6	0.33333333333333337
4687	Sc_chr04	1528573	1528872	299	0.4782608695652174
4688	Sc_chr04	1528872	1528965	93	0.4731182795698925
4689	Sc_chr04	1528965	1528975	10	0.4
4690	Sc_chr04	1528975	1529281	306	0.47385620915032683
4691	Sc_chr04	1529281	1529661	380	0.4473684210526316
4692	Sc_chr04	1529661	1529976	315	0.4476190476190476
4693	Sc_chr04	1529976	1530981	1005	0.4696517412935324
4694	Sc_chr04	1530981	1531110	129	0.43410852713178294
4695	Sc_chr04	1531110	1531393	283	0.47703180212014135
4696	Sc_chr04	1531393	1531933	540	0.39814814814814814
